
border_size=1
usage=map

       Ww,       Ww,       Ww,       Mm,       Mm,       Mm,       Mm,       Mm,       Mm,       Mm,       Mm,       Mm,       Mm,       Mm,       Mm,       Mm,       Mm,       Mm,       Mm,       Mm,       Mm,       Mm,       Mm,       Mm,       Hh,    Gs^Fp,    Gs^Fp,       Re,    Gs^Fp,    Gs^Fp,       Mm,       Mm
       Ww,       Ww,       Ww,       Mm,       Mm,       Mm,       Mm,       Mm,       Mm,       Mm,       Mm,       Mm,       Mm,       Mm,       Mm,       Mm,       Mm,       Mm,       Mm,       Mm,       Mm,       Mm,       Mm,       Mm,       Hh,    Gs^Fp,    Gs^Fp,       Re,    Gs^Fp,    Gs^Fp,       Mm,       Mm
       Mm,       Mm,       Mm,       Mm,       Mm,       Mm,       Mm,       Mm,       Mm,       Mm,       Mm,       Mm,       Mm,       Mm,       Mm,       Mm,       Mm,       Mm,       Mm,       Mm,       Mm,       Mm,       Mm,       Hh,       Hh,    Gs^Fp,       Re,       Re,    Gs^Fp,       Hh,       Mm,       Mm
       Mm,       Mm,       Mm,       Mm,       Mm,       Mm,    Gg^Ve,       Mm,       Mm,       Mm,       Mm,       Mm,       Mm,       Mm,       Mm,       Mm,       Mm,       Mm,    Gg^Ve,       Mm,       Mm,       Mm,       Mm,       Hh,       Hh,    Gs^Fp,       Re,    Gs^Fp,       Hh,       Hh,       Mm,       Mm
       Mm,       Mm,       Mm,       Mm,       Mm,       Mm,       Mm,       Mm,       Hh,       Mm,       Mm,    Gg^Ve,       Mm,       Mm,       Mm,       Gg,       Gg,       Gg,       Gg,       Gg,       Gg,       Gg,       Gg,       Gg,       Gg,       Gg,       Re,    Gs^Fp,    Gg^Ve,       Hh,       Mm,       Mm
       Mm,       Mm,       Mm,       Mm,       Mm,       Mm,       Mm,       Mm,    Gg^Vh,       Hh,       Mm,       Mm,       Mm,       Mm,       Mm,       Hh,    Gg^Ve,       Hh,       Hh,       Hh,       Hh,       Hh,       Hh,       Hh,       Gg,       Gg,       Re,       Gg,       Mm,       Mm,       Mm,       Mm
       Mm,       Mm,       Mm,       Mm,       Mm,       Mm,       Mm,       Hh,       Mm,    Gs^Fp,    Gs^Fp,    Gs^Fp,       Gg,       Gg,       Gg,       Gg,       Gg,       Gg,       Gg,       Gg,       Ch,       Ch,       Ch,       Gg,       Re,       Re,    Gg^Ve,       Hh,       Mm,       Mm,       Mm,       Mm
       Mm,       Mm,       Mm,       Mm,    Gg^Ve,       Mm,       Mm,       Mm,       Mm,       Ww,       Gg,       Gg,       Gg,       Gg,       Gg,       Gg,       Gg,       Gg,       Gg,       Gg,       Ch,     1 Kh,       Ch,       Re,       Gg,       Gg,       Hh,       Hh,       Mm,       Mm,       Mm,       Mm
       Mm,       Mm,       Mm,       Mm,       Mm,       Mm,       Mm,       Mm,       Mm,       Mm,       Mm,    Gg^Ve,    Gs^Fp,    Gs^Fp,    Gs^Fp,       Gg,       Gg,       Ww,       Ww,       Ww,       Ww,   Ww^Bw|,       Re,       Re,       Ss,       Ss,       Hh,       Hh,       Mm,       Mm,       Mm,       Mm
       Mm,       Mm,       Mm,       Mm,       Mm,       Mm,    Gg^Ve,       Mm,       Mm,       Mm,       Mm,    Gs^Fp,    Gs^Fp,    Gs^Fp,    Gs^Fp,       Gg,       Gg,       Ww,       Ww,       Ww,       Ww,       Ww,       Ww,       Ww,       Ww,       Ww,       Mm,       Mm,       Mm,       Mm,       Mm,       Mm
       Mm,       Mm,       Mm,       Mm,       Mm,       Mm,       Mm,       Mm,       Mm,       Mm,       Mm,    Gs^Fp,    Gs^Fp,    Gs^Fp,    Gg^Ve,       Gg,       Gg,       Ww,       Ww,       Ww,       Hh,       Hh,       Hh,       Hh,       Ww,       Ww,       Ww,       Ww,       Ww,       Ww,       Ww,       Ww
       Mm,       Mm,       Mm,       Mm,       Mm,       Mm,       Mm,       Mm,       Mm,       Mm,    Gg^Ve,    Gs^Fp,    Gs^Fp,       Gg,       Gg,       Gg,       Ww,       Ww,       Ww,       Hh,       Hh,       Mm,       Mm,    Gg^Ve,       Mm,       Mm,       Mm,       Mm,       Mm,       Mm,       Mm,       Mm
       Mm,       Mm,       Mm,       Mm,       Mm,       Mm,       Mm,       Hh,       Hh,    Gs^Fp,    Gs^Fp,    Gs^Fp,       Gg,       Gg,       Ww,       Ww,       Ww,       Gg,       Re,       Hh,       Hh,       Mm,       Mm,       Mm,       Mm,       Mm,       Mm,       Mm,       Mm,       Mm,       Mm,       Mm
       Mm,       Mm,       Mm,       Mm,       Mm,       Mm,       Mm,       Mm,       Mm,       Hh,       Hh,    Gs^Fp,       Gg,       Ww,       Ww,       Ww,       Gg,       Gg,       Re,       Hh,       Mm,       Mm,       Mm,    Gg^Ve,       Mm,       Mm,       Mm,       Mm,       Mm,       Mm,       Mm,       Mm
       Mm,       Mm,       Mm,       Mm,    Gs^Fp,    Gs^Fp,    Gs^Fp,    Gs^Fp,    Gg^Ve,       Gg,       Gg,       Ww,       Ww,       Ww,       Ww,       Ww,       Re,       Re,       Hh,       Mm,       Mm,       Mm,       Mm,       Mm,       Mm,       Mm,       Mm,       Mm,       Mm,       Mm,       Mm,       Mm
       Mm,       Mm,       Mm,       Mm,    Gs^Fp,    Gs^Fp,    Gs^Fp,       Ww,       Ww,       Ww,       Ww,       Ww,       Gg,       Re,       Ww,       Ww,       Re,       Hh,       Hh,       Mm,       Mm,       Mm,       Mm,       Mm,    Gg^Ve,       Mm,       Mm,       Mm,       Mm,       Mm,       Mm,       Mm
       Mm,       Mm,       Mm,       Mm,       Mm,    Gs^Fp,    Gg^Ve,       Ww,       Ww,    Gs^Fp,    Gg^Ve,    Gs^Fp,    Gs^Fp,       Ww,       Mm,       Hh,       Mm,       Mm,       Mm,       Mm,       Mm,       Mm,       Mm,       Mm,    Gg^Ve,       Mm,       Mm,       Mm,       Mm,       Mm,       Mm,       Mm
       Mm,       Mm,       Mm,       Mm,       Hh,       Hh,       Ww,       Ww,       Ww,    Gs^Fp,    Gs^Fp,       Ww,       Ww,       Ww,       Mm,       Ch,       Ch,       Ch,       Ch,       Mm,       Mm,       Mm,       Mm,       Mm,       Mm,       Hh,       Hh,       Mm,       Mm,       Mm,       Mm,       Mm
       Mm,       Mm,       Hh,       Hh,       Hh,       Ww,       Ww,       Ww,    Gg^Ve,    Gs^Fp,       Ww,       Ww,       Mm,       Mm,       Mm,       Ch,     2 Kh,       Ch,       Ch,       Mm,       Mm,       Mm,       Mm,       Mm,       Mm,       Mm,       Hh,    Gs^Fp,       Mm,       Mm,       Mm,       Mm
       Mm,       Mm,       Hh,       Hh,       Ww,       Ww,       Ww,       Re,    Gs^Fp,    Gs^Fp,       Ww,       Ww,       Mm,       Mm,       Mm,       Ch,       Ch,       Ch,       Ch,       Mm,       Mm,       Mm,       Mm,    Gg^Ve,       Mm,       Hh,       Hh,       Hh,       Mm,       Mm,       Mm,       Mm
       Mm,       Mm,       Hh,       Hh,       Ww,       Ww,       Ww,    Gs^Fp,    Gs^Fp,       Ww,       Ww,       Mm,       Mm,       Mm,    Gs^Fp,    Gs^Fp,    Gs^Fp,    Gs^Fp,    Gs^Fp,    Gs^Fp,    Gs^Fp,       Mm,       Mm,       Mm,    Gs^Fp,       Hh,       Mm,       Mm,       Mm,       Mm,       Mm,       Mm
    Gs^Fp,    Gs^Fp,    Gs^Fp,       Ww,       Ww,       Ww,       Ww,       Ww,       Ww,       Ww,    Gs^Fp,    Gs^Fp,    Gs^Fp,    Gs^Fp,    Gs^Fp,    Gs^Fp,    Gs^Fp,    Gs^Fp,    Gs^Fp,    Gs^Fp,    Gs^Fp,    Gs^Fp,    Gs^Fp,       Mm,       Hh,       Hh,       Mm,       Mm,       Mm,       Mm,       Mm,       Mm
    Gs^Fp,    Gs^Fp,    Gg^Ve,       Ww,       Ww,       Ww,       Gg,       Gg,    Gs^Fp,    Gs^Fp,    Gs^Fp,       Mm,       Mm,       Mm,       Mm,       Mm,       Mm,       Mm,       Mm,       Mm,       Mm,       Mm,       Mm,    Gg^Ve,       Hh,       Mm,       Mm,       Mm,       Mm,       Mm,       Mm,       Mm
    Gs^Fp,    Gs^Fp,    Gs^Fp,       Gg,       Gg,       Ww,       Ww,       Ww,       Re,       Hh,    Gs^Fp,       Hh,    Gs^Fp,       Hh,       Hh,       Mm,       Mm,       Mm,       Mm,       Mm,       Mm,       Mm,       Mm,       Mm,       Hh,       Hh,       Hh,       Mm,       Mm,       Mm,       Mm,       Mm
    Gs^Fp,    Gs^Fp,    Gs^Fp,    Gs^Fp,       Gg,       Gg,       Gg,       Ww,       Ww,       Ww,       Re,       Re,    Gs^Fp,    Gs^Fp,    Gs^Fp,       Hh,       Hh,       Hh,       Mm,       Mm,       Mm,    Gs^Fp,    Gs^Fp,    Gs^Fp,       Mm,       Mm,       Mm,       Mm,       Mm,       Mm,       Mm,       Mm
       Mm,       Mm,       Mm,       Mm,    Gg^Ve,       Mm,       Hh,       Ww,       Ww,       Ww,       Ww,       Ww,       Ww,       Gg,       Re,       Re,    Gg^Ve,       Gg,       Hh,       Hh,       Hh,       Mm,       Mm,       Mm,       Mm,       Mm,    Gg^Ve,       Mm,       Mm,       Mm,       Mm,       Mm
       Mm,       Mm,       Ch,       Ch,       Ch,       Ch,       Mm,       Hh,       Hh,    Gs^Fp,       Ww,       Ww,       Ww,       Ww,       Ww,       Gg,       Gg,       Hh,       Hh,       Mm,       Mm,       Mm,       Mm,       Mm,       Mm,       Mm,       Mm,       Mm,       Mm,       Mm,       Mm,       Mm
       Mm,       Mm,       Ch,     3 Kh,       Ch,       Mm,       Mm,       Mm,       Mm,    Gs^Fp,    Gs^Fp,    Gs^Fp,       Gg,       Gg,       Ww,       Ww,       Ww,       Ww,       Ww,       Mm,       Mm,       Mm,       Mm,       Mm,       Mm,       Mm,       Mm,       Mm,       Mm,       Mm,       Mm,       Mm
       Mm,       Mm,       Ch,       Ch,       Ch,       Ch,       Mm,       Mm,       Mm,       Mm,       Mm,       Mm,       Hh,       Gg,       Ww,       Ww,       Ww,       Ww,       Ww,       Mm,       Mm,       Mm,       Mm,       Mm,       Mm,       Mm,       Hh,       Mm,       Mm,       Mm,       Mm,       Mm
       Mm,       Mm,       Mm,       Mm,       Mm,       Mm,       Mm,       Mm,       Mm,       Mm,       Mm,       Hh,       Hh,    Gs^Fp,       Re,       Ww,       Ww,       Ww,       Ww,       Mm,       Mm,       Mm,       Mm,       Mm,       Mm,       Mm,       Mm,       Mm,    Gs^Fp,       Mm,       Mm,       Mm
       Mm,       Mm,       Mm,       Mm,       Mm,       Mm,       Mm,       Mm,       Mm,       Mm,       Mm,       Hh,       Hh,    Gs^Fp,       Re,       Gg,       Ww,       Ww,       Ww,       Ww,       Mm,       Mm,       Mm,    Gg^Ve,       Mm,       Mm,       Mm,       Mm,    Gs^Fp,       Mm,       Mm,       Mm
       Mm,       Mm,       Mm,       Mm,       Mm,       Mm,       Mm,       Mm,       Mm,       Mm,       Mm,       Hh,       Hh,    Gs^Fp,       Re,    Gg^Ve,    Gs^Fp,       Hh,       Ww,       Ww,       Ww,       Ww,       Mm,       Mm,       Mm,       Mm,       Mm,       Mm,       Mm,       Mm,       Mm,       Mm
       Mm,       Mm,       Mm,       Mm,       Mm,       Mm,       Mm,    Gs^Fp,    Gs^Fp,    Gs^Fp,    Gs^Fp,    Gs^Fp,    Gs^Fp,       Gg,       Re,    Gs^Fp,       Hh,       Hh,       Mm,       Ww,       Ww,       Ww,       Mm,       Mm,       Mm,       Mm,       Hh,       Mm,       Mm,       Mm,       Mm,       Mm
       Mm,       Mm,       Mm,       Mm,       Mm,       Mm,       Mm,       Mm,       Mm,       Mm,       Mm,       Mm,       Mm,       Gg,       Re,       Gg,       Hh,       Hh,       Hh,       Mm,       Ww,       Ww,       Ww,    Gg^Ve,       Mm,       Hh,       Mm,       Mm,       Mm,       Mm,       Mm,       Mm
       Mm,       Mm,       Mm,       Mm,       Mm,       Mm,       Mm,       Mm,       Mm,       Mm,       Mm,       Mm,       Mm,    Gg^Vh,       Re,       Gg,       Gg,       Hh,       Hh,       Mm,       Ww,       Ww,       Ww,       Mm,       Hh,       Hh,    Gg^Ve,       Mm,       Hh,       Mm,       Mm,       Mm
       Mm,       Mm,       Hh,       Mm,       Mm,       Mm,       Mm,       Mm,       Mm,       Mm,       Mm,       Mm,       Hh,       Hh,       Hh,       Re,       Re,       Gg,       Gg,       Hh,       Ww,       Ww,       Ww,       Hh,       Gg,    Gs^Fp,    Gs^Fp,       Mm,       Hh,    Gs^Fp,    Gs^Fp,    Gs^Fp
       Mm,       Mm,       Hh,       Mm,    Gg^Ve,       Mm,       Mm,       Mm,       Mm,       Mm,       Mm,       Mm,       Mm,       Mm,       Mm,       Hh,       Hh,       Re,       Re,    Gs^Fp,       Ww,       Ww,       Ww,       Hh,    Gs^Fp,    Gs^Fp,    Gs^Fp,       Mm,       Gg,    Gs^Fp,    Gs^Fp,    Gs^Fp
       Mm,       Mm,       Mm,       Mm,       Mm,       Mm,       Mm,       Mm,       Mm,       Mm,       Mm,       Mm,       Mm,       Mm,       Mm,       Mm,       Hh,    Gs^Fp,    Gs^Fp,       Re,       Ww,       Ww,       Ww,       Ww,       Gg,    Gs^Fp,    Gs^Fp,       Mm,       Gg,    Gs^Fp,       Hh,       Hh
       Hh,       Hh,       Mm,       Mm,       Mm,       Mm,       Mm,       Mm,       Mm,       Mm,       Mm,       Mm,       Mm,       Mm,       Hh,       Mm,       Hh,       Hh,    Gs^Fp,       Ww,       Ww,       Ww,       Ww,       Gg,    Gs^Fp,       Gg,       Gg,       Mm,       Mm,       Gg,       Hh,       Hh
       Mm,       Mm,       Mm,       Mm,       Mm,       Mm,       Mm,       Mm,    Gg^Ve,       Mm,       Mm,       Mm,       Hh,       Hh,       Hh,       Hh,       Gg,       Gg,       Gg,       Ww,       Ww,       Ww,       Ww,       Gg,    Gs^Fp,    Gs^Fp,    Gs^Fp,       Gg,   Ww^Bw\,       Gg,    Gs^Fp,    Gs^Fp
       Mm,       Mm,       Mm,       Mm,       Mm,       Mm,       Mm,       Mm,       Mm,       Mm,       Mm,       Mm,       Mm,    Gs^Fp,    Gs^Fp,    Gs^Fp,    Gs^Fp,    Gs^Fp,    Gs^Fp,       Ww,       Ww,       Ww,       Gg,    Gs^Fp,    Gs^Fp,    Gs^Fp,    Gs^Fp,    Gs^Fp,       Mm,       Mm,       Gg,       Gg
       Mm,       Mm,       Mm,       Mm,       Mm,       Mm,       Mm,       Mm,       Mm,       Mm,       Mm,       Mm,       Mm,    Gs^Fp,    Gs^Fp,    Gs^Fp,    Gs^Fp,    Gs^Fp,    Gs^Fp,       Ww,       Ww,       Ww,       Gg,    Gs^Fp,    Gs^Fp,    Gs^Fp,    Gs^Fp,    Gs^Fp,       Mm,       Mm,       Gg,       Gg
