
border_size=1
usage=map

       Mm,       Mm,       Hh,       Ch,       Ch,       Ch,       Ds,       Gg,       Ds,       Gg,       Gg,    Gs^Fp,    Gs^Fp,    Gs^Fp,    Gg^Ve,    Gg^Vh,    Gs^Fp,       Gg,       Gg,       Mm,    Gg^Ve,       Mm,       Mm,       Mm,       Mm,       Mm,       Mm,       Mm,       Mm,       Mm
       Mm,       Mm,       Hh,       Ch,       Ch,       Ch,       Ds,       Gg,       Ds,       Gg,       Gg,    Gs^Fp,    Gs^Fp,    Gs^Fp,    Gg^Ve,    Gg^Vh,    Gs^Fp,       Gg,       Gg,       Mm,    Gg^Ve,       Mm,       Mm,       Mm,       Mm,       Mm,       Mm,       Mm,       Mm,       Mm
       Mm,       Mm,       Mm,       Ch,     3 Kh,       Ch,       Gg,       Gg,       Gg,       Gg,       Ds,       Gg,       Ds,       Gg,       Ds,    Gs^Fp,    Gs^Fp,       Gg,       Ss,       Mm,       Mm,       Mm,       Mm,       Mm,       Mm,    Gs^Fp,       Hh,       Hh,       Hh,       Hh
       Hh,       Hh,       Hh,       Ch,       Ch,       Ch,       Gg,       Gg,       Ds,       Ds,       Gg,       Ds,       Ds,       Ds,       Ds,       Gg,       Gg,       Ss,       Gg,       Ss,   Ss^Vhs,       Gg,       Gg,       Gg,    Gg^Ve,    Gs^Fp,       Hh,       Hh,    Gs^Fp,    Gs^Fp
       Hh,       Hh,       Hh,       Hh,       Hh,       Gg,       Gg,       Gg,       Gg,       Gg,       Gg,       Gg,       Gg,       Gg,       Gg,       Gg,       Gg,       Gg,       Gg,       Hh,       Hh,       Hh,    Gs^Fp,    Gs^Fp,       Hh,       Hh,    Gs^Fp,    Gs^Fp,    Gs^Fp,    Gs^Fp
       Hh,       Hh,       Hh,       Hh,       Hh,       Gg,       Gg,       Gg,       Gg,       Gg,       Gg,       Gg,       Gg,       Gg,       Gg,       Gg,       Gg,       Gg,       Gg,       Gg,       Gg,       Gg,       Gg,       Gg,    Gs^Fp,    Gs^Fp,    Gs^Fp,    Gs^Fp,    Gs^Fp,    Gs^Fp
       Hh,       Hh,       Hh,       Hh,       Hh,       Hh,       Gg,       Gg,       Gg,       Gg,       Gg,       Gg,       Gg,       Gg,       Gg,       Gg,       Gg,       Gg,       Gg,       Gg,       Gg,       Gg,       Gg,    Gs^Fp,    Gs^Fp,    Gs^Fp,    Gs^Fp,    Gs^Fp,    Gs^Fp,    Gs^Fp
       Hh,       Hh,       Hh,       Hh,       Hh,       Hh,       Gg,       Gg,       Gg,       Gg,       Gg,       Gg,       Gg,       Gg,       Gg,       Gg,       Gg,       Gg,       Gg,       Gg,       Gg,       Gg,       Gg,       Gg,    Gs^Fp,    Gs^Fp,    Gs^Fp,    Gs^Fp,    Gs^Fp,    Gs^Fp
       Hh,       Hh,       Hh,       Hh,       Hh,       Hh,       Gg,       Gg,       Gg,       Gg,       Gg,       Gg,       Gg,       Gg,       Gg,       Gg,       Gg,       Gg,       Gg,       Gg,       Gg,       Gg,       Gg,       Gg,    Gs^Fp,    Gs^Fp,    Gs^Fp,    Gs^Fp,    Gs^Fp,    Gs^Fp
       Hh,       Hh,       Hh,       Gg,       Gg,       Gg,       Gg,       Gg,       Ds,       Gg,    Gg^Vh,       Gg,       Ds,    Gg^Ve,       Gg,       Gg,    Gg^Vh,       Gg,       Gg,       Gg,       Gg,       Gg,       Gg,       Gg,       Gg,       Gg,    Gs^Fp,    Gs^Fp,    Gs^Fp,    Gs^Fp
       Hh,       Hh,       Hh,       Hh,       Gg,       Gg,       Gg,       Gg,       Ds,       Ds,       Ds,       Ds,       Ds,       Ds,       Ds,       Ds,       Ds,       Ds,    Gs^Fp,    Gs^Fp,    Gs^Fp,       Ss,       Gg,       Gg,       Gg,    Gs^Fp,    Gs^Fp,    Gs^Fp,    Gs^Fp,    Gs^Fp
       Hh,       Hh,       Hh,       Hh,       Hh,       Hh,       Gg,       Gg,       Gg,       Ds,       Ds,       Ds,       Ds,       Gg,       Ds,       Ds,    Gg^Ve,       Ds,    Gs^Fp,    Gs^Fp,       Ss,       Ss,       Gg,       Ss,       Ss,    Gs^Fp,    Gs^Fp,    Gs^Fp,    Gs^Fp,    Gs^Fp
       Hh,       Hh,       Hh,       Hh,       Hh,       Hh,       Hh,       Gg,       Gg,       Gg,       Gg,       Gg,       Gg,       Gg,       Gg,       Ds,       Gg,       Gg,       Gg,       Ss,       Ss,       Gg,       Gg,    Gs^Fp,    Gs^Fp,    Gs^Fp,    Gs^Fp,    Gs^Fp,    Gs^Fp,    Gs^Fp
       Mm,       Mm,       Hh,       Hh,       Hh,       Hh,       Hh,       Hh,       Gg,       Gg,       Gg,       Gg,       Gg,    Gg^Ve,    Gs^Fp,       Gg,       Gg,       Ss,       Ss,       Ss,   Ss^Vhs,       Ss,       Gg,       Gg,       Ss,       Gg,       Gg,       Gg,       Gg,       Gg
       Mm,       Mm,       Hh,       Hh,       Hh,       Hh,       Hh,       Hh,       Hh,       Gg,    Gs^Fp,    Gs^Fp,    Gs^Fp,    Gs^Fp,    Gs^Fp,       Gg,       Gg,       Ss,       Ss,       Gg,       Ss,       Ss,       Ss,       Ss,       Ss,       Gg,       Gg,       Gg,       Gg,       Gg
       Mm,       Mm,       Hh,       Hh,       Hh,       Hh,       Hh,    Gs^Fp,    Gs^Fp,    Gs^Fp,    Gg^Ve,    Gs^Fp,    Gs^Fp,    Gs^Fp,       Gg,       Gg,       Gg,       Gg,       Ww,       Ss,       Ww,       Ss,       Ss,       Ss,       Gg,       Gg,       Gg,       Gg,       Gg,       Gg
       Mm,       Mm,       Hh,       Hh,    Gs^Fp,    Gs^Fp,    Gs^Fp,    Gs^Fp,       Gg,       Gg,       Gg,    Gs^Fp,    Gs^Fp,    Gs^Fp,    Gs^Fp,       Ss,       Ss,       Gg,       Gg,       Gg,       Gg,       Gg,       Gg,       Gg,       Gg,       Gg,       Gg,       Gg,       Gg,       Gg
       Mm,       Mm,       Hh,       Hh,    Gs^Fp,    Gs^Fp,       Gg,       Gg,       Gg,       Gg,       Gg,       Gg,       Gg,       Gg,       Gg,       Gg,       Gg,       Hh,       Hh,    Gg^Vh,       Ss,       Gg,       Ss,       Gg,       Ww,       Ww,    Gs^Fp,    Gs^Fp,    Gs^Fp,    Gs^Fp
       Mm,       Mm,       Hh,       Hh,       Hh,       Hh,       Hh,       Hh,    Gs^Fp,    Gs^Fp,       Gg,       Gg,       Gg,       Gg,       Ss,       Ss,       Gg,       Gg,       Gg,       Ss,       Gg,       Gg,       Gg,       Gg,       Gg,       Ch,       Ch,       Ch,    Gs^Fp,    Gs^Fp
       Hh,       Hh,       Hh,       Hh,       Hh,       Hh,       Hh,       Gg,       Gg,       Gg,       Gg,       Gg,       Gg,       Ss,       Ss,       Gg,       Gg,       Gg,       Gg,       Gg,       Gg,    Gs^Fp,    Gs^Fp,    Gs^Fp,    Gs^Fp,    Gs^Fp,       Ch,     1 Kh,       Ch,       Ch
       Hh,       Hh,       Hh,       Hh,       Hh,       Hh,       Hh,       Hh,       Hh,       Hh,       Gg,       Gg,    Gg^Vh,       Ss,       Gg,       Gg,       Ss,   Ss^Vhs,       Ss,       Ss,       Ss,       Gg,       Gg,    Gs^Fp,    Gs^Fp,    Gs^Fp,       Ch,       Ch,       Ch,       Ch
       Hh,       Hh,       Hh,       Hh,       Hh,       Hh,       Hh,       Hh,       Hh,       Hh,       Hh,       Gg,       Ds,       Gg,       Ds,       Gg,    Gs^Fp,       Gg,       Ss,       Ss,       Gg,       Ss,       Gg,       Ss,       Gg,    Gs^Fp,    Gs^Fp,    Gs^Fp,    Gs^Fp,    Gs^Fp
       Hh,       Hh,       Hh,       Hh,       Hh,       Hh,       Gg,       Gg,       Gg,       Gg,       Ds,       Gg,       Ds,       Ds,       Ds,       Gg,    Gs^Fp,    Gs^Fp,    Gs^Fp,       Gg,       Gg,    Gg^Vh,       Gg,       Gg,       Ss,    Gs^Fp,    Gs^Fp,    Gs^Fp,    Gs^Fp,    Gs^Fp
       Hh,       Hh,       Hh,       Hh,       Gg,       Gg,       Gg,       Ds,       Gg,       Gg,       Gg,       Ds,       Ds,       Gg,       Ds,       Gg,       Gg,    Gs^Fp,       Ds,       Ds,       Gg,       Gg,       Gg,       Ss,   Ss^Vhs,       Gg,       Gg,    Gs^Fp,    Gs^Fp,    Gs^Fp
       Hh,       Hh,       Hh,       Hh,       Gg,       Gg,       Gg,       Ch,     2 Kh,       Ch,       Ds,       Ds,    Gg^Ve,       Gg,       Gg,       Gg,       Ds,       Ds,       Ds,       Ds,       Ds,    Gs^Fp,    Gs^Fp,    Gs^Fp,    Gs^Fp,    Gs^Fp,    Gs^Fp,    Gs^Fp,    Gs^Fp,    Gs^Fp
       Hh,       Hh,       Hh,       Hh,       Gg,       Gg,    Gg^Ve,       Ds,       Ch,       Ds,       Gg,       Gg,       Ds,       Ds,       Ds,       Gg,       Gg,    Gg^Ve,       Ds,       Ds,       Ds,       Ds,    Gs^Fp,    Gs^Fp,    Gs^Fp,    Gs^Fp,    Gs^Fp,    Gs^Fp,    Gs^Fp,    Gs^Fp
       Hh,       Hh,       Hh,       Hh,       Hh,       Gg,       Gg,       Gg,       Gg,   Ww^Bw\,       Ds,       Ds,    Gg^Vh,       Ds,       Ds,       Ds,       Ds,       Gg,       Gg,       Gg,       Ds,       Gg,       Ss,       Ww,       Ss,       Gg,       Gg,       Gg,       Gg,       Gg
       Hh,       Hh,       Hh,       Hh,       Hh,       Hh,       Gg,       Gg,       Gg,       Gg,       Gg,       Gg,       Gg,       Ds,       Ds,       Ds,       Gg,    Gg^Vh,       Gg,       Gg,       Gg,       Gg,       Gg,       Gg,       Gg,       Gg,       Gg,       Gg,       Gg,       Gg
       Hh,       Hh,       Hh,    Gg^Ve,       Hh,       Hh,       Gg,       Gg,       Gg,       Gg,       Gg,    Gs^Fp,    Gs^Fp,    Gs^Fp,    Gs^Fp,    Gs^Fp,    Gs^Fp,    Gg^Ve,    Gs^Fp,    Gs^Fp,    Gs^Fp,    Gs^Fp,    Gg^Ve,    Gs^Fp,    Gs^Fp,    Gs^Fp,       Gg,       Gg,       Gg,       Gg
       Wo,       Wo,       Ww,       Ww,    Gs^Fp,    Gs^Fp,    Gs^Fp,    Gs^Fp,    Gg^Ve,    Gs^Fp,    Gs^Fp,       Ds,    Gg^Vh,       Ds,       Gg,       Gg,       Gg,    Gs^Fp,       Gg,       Gg,       Gg,    Gs^Fp,    Gs^Fp,    Gg^Ve,    Gs^Fp,       Gg,       Gg,       Gg,       Gg,       Gg
       Wo,       Wo,       Ww,    Gs^Fp,    Gs^Fp,    Gs^Fp,    Gs^Fp,    Gs^Fp,    Gs^Fp,    Gs^Fp,    Gs^Fp,    Gs^Fp,    Gs^Fp,    Gs^Fp,    Gs^Fp,    Gs^Fp,    Gs^Fp,    Gs^Fp,    Gs^Fp,    Gs^Fp,    Gs^Fp,    Gs^Fp,    Gs^Fp,    Gs^Fp,    Gs^Fp,    Gs^Fp,       Gg,       Gg,       Gg,       Gg
       Wo,       Wo,       Ww,    Gs^Fp,    Gs^Fp,    Gs^Fp,    Gs^Fp,    Gs^Fp,    Gs^Fp,    Gs^Fp,    Gs^Fp,    Gs^Fp,    Gs^Fp,    Gs^Fp,    Gs^Fp,    Gs^Fp,    Gs^Fp,    Gs^Fp,    Gs^Fp,    Gs^Fp,    Gs^Fp,    Gs^Fp,    Gs^Fp,    Gs^Fp,    Gs^Fp,    Gs^Fp,       Gg,       Gg,       Gg,       Gg
