
border_size=1
usage=map

       Mm,       Mm,       Mm,       Mm,       Mm,       Ch,       Ch,       Ch,       Ch,       Hh,       Hh,       Hh,       Hh,       Hh,       Hh,       Hh,       Hh,       Hh,       Hh,       Hh,       Hh,       Hh,       Ch,       Ch,       Ch,       Hh,       Hh,       Hh,       Hh,       Hh,       Hh,       Hh,       Hh,       Ch,       Ch,       Ch,       Ch,       Hh,       Hh
       Mm,       Mm,       Mm,       Mm,       Mm,       Ch,       Ch,       Ch,       Ch,       Hh,       Hh,       Hh,       Hh,       Hh,       Hh,       Hh,       Hh,       Hh,       Hh,       Hh,       Hh,       Hh,       Ch,       Ch,       Ch,       Hh,       Hh,       Hh,       Hh,       Hh,       Hh,       Hh,       Hh,       Ch,       Ch,       Ch,       Ch,       Hh,       Hh
       Mm,       Mm,       Mm,       Mm,       Mm,       Mm,       Hh,       Ch,     5 Kh,       Ch,       Hh,       Hh,       Hh,       Hh,       Hh,       Hh,       Hh,       Hh,       Hh,       Hh,       Hh,       Ch,     6 Kh,       Ch,       Hh,       Hh,       Hh,       Hh,       Hh,       Hh,       Hh,       Hh,       Hh,       Ch,     4 Kh,    Gs^Fp,    Gs^Fp,    Gs^Fp,    Gs^Fp
       Hh,       Hh,       Hh,       Mm,       Mm,       Mm,       Mm,       Hh,       Hh,       Hh,       Hh,       Hh,       Hh,       Hh,       Hh,       Hh,       Hh,       Hh,       Hh,       Hh,       Hh,       Hh,       Ch,       Hh,       Hh,       Hh,       Hh,       Hh,       Hh,       Hh,       Hh,       Hh,       Hh,       Ch,       Ch,       Hh,       Hh,    Gs^Fp,    Gs^Fp
       Ww,       Ww,       Ww,       Ww,       Mm,       Mm,       Mm,       Hh,       Hh,       Hh,       Hh,       Hh,       Hh,       Hh,       Hh,       Hh,       Hh,       Hh,       Hh,       Hh,       Hh,       Hh,       Hh,       Hh,       Hh,       Hh,       Hh,       Hh,       Hh,       Hh,       Hh,       Hh,       Hh,       Hh,       Hh,       Hh,       Hh,    Gs^Fp,    Gs^Fp
       Ww,       Ww,       Ww,       Ww,       Mm,       Mm,       Mm,       Ch,       Ch,       Ch,       Ch,       Hh,       Hh,       Hh,       Hh,       Hh,       Hh,       Hh,       Hh,       Ch,       Ch,       Ch,       Ch,       Hh,       Hh,       Hh,       Hh,       Hh,       Hh,       Hh,       Hh,       Hh,       Hh,       Hh,       Hh,       Hh,       Hh,    Gs^Fp,    Gs^Fp
       Ww,       Ww,       Ww,       Ww,       Mm,       Mm,       Mm,       Ch,       Ch,     2 Kh,       Ch,       Hh,       Hh,       Hh,       Hh,       Hh,       Hh,       Hh,       Hh,       Hh,       Ch,     3 Kh,       Ch,       Hh,       Hh,       Hh,       Hh,       Hh,       Hh,       Hh,       Hh,       Hh,       Hh,       Hh,       Hh,       Hh,       Hh,    Gs^Fp,    Gs^Fp
       Ww,       Ww,       Ww,       Mm,       Mm,       Mm,       Mm,       Ch,       Ch,       Ch,       Ch,       Hh,       Hh,       Hh,       Hh,       Hh,       Hh,       Hh,       Hh,       Ch,       Ch,       Ch,       Hh,       Hh,       Hh,       Hh,       Hh,       Hh,       Hh,       Hh,       Hh,       Hh,       Hh,       Hh,       Hh,       Hh,       Hh,    Gs^Fp,    Gs^Fp
       Ww,       Ww,       Gg,       Hh,       Hh,       Hh,       Hh,       Hh,       Rr,       Rr,       Hh,       Hh,       Hh,       Hh,       Hh,       Hh,       Hh,       Hh,       Hh,       Hh,       Hh,       Hh,       Hh,       Hh,       Hh,       Hh,       Hh,       Hh,       Hh,       Hh,       Hh,       Hh,       Hh,       Hh,       Hh,       Hh,       Hh,    Gs^Fp,    Gs^Fp
       Gg,       Gg,       Gg,       Gg,       Gg,       Gg,       Gg,       Gg,       Rr,       Rr,       Hh,       Hh,       Hh,       Hh,       Hh,       Hh,       Hh,       Hh,       Hh,       Hh,       Hh,       Hh,       Hh,       Hh,       Hh,       Hh,       Hh,       Hh,       Hh,       Hh,       Hh,       Hh,       Hh,       Hh,       Hh,       Hh,    Gs^Fp,    Gs^Fp,    Gs^Fp
    Gs^Fp,    Gs^Fp,    Gs^Fp,       Gg,       Gg,       Gg,       Gg,       Gg,       Rr,       Rr,       Hh,       Hh,       Hh,       Hh,       Hh,       Hh,       Hh,       Hh,       Hh,       Hh,       Hh,       Hh,       Hh,       Hh,       Hh,       Hh,       Hh,       Hh,       Hh,       Hh,       Hh,       Hh,       Hh,       Hh,       Hh,       Hh,       Hh,       Hh,       Hh
       Ce,       Ce,     1 Ke,    Gs^Fp,       Gg,       Gg,       Gg,       Gg,       Rr,       Rr,       Gg,       Hh,       Hh,       Hh,       Hh,       Hh,       Hh,       Hh,       Hh,       Hh,       Hh,       Hh,       Hh,       Hh,       Hh,       Hh,       Hh,       Hh,       Hh,       Hh,       Hh,       Hh,       Hh,       Hh,       Hh,       Hh,       Hh,       Hh,       Hh
    Gs^Fp,    Gs^Fp,    Gs^Fp,    Gs^Fp,    Gs^Fp,    Gs^Fp,       Gg,       Gg,       Rr,       Rr,       Gg,       Gg,       Gg,       Gg,       Hh,       Hh,       Hh,       Hh,       Hh,       Hh,       Hh,       Hh,       Hh,       Hh,       Hh,       Hh,       Hh,       Hh,       Hh,       Hh,       Hh,       Hh,       Hh,       Hh,       Hh,       Hh,       Hh,       Hh,       Hh
    Gs^Fp,    Gs^Fp,    Gs^Fp,       Ce,     7 Ke,    Gs^Fp,    Gs^Fp,       Gg,       Rr,       Rr,       Gg,       Gg,       Gg,       Gg,       Gg,       Gg,       Hh,       Hh,       Hh,       Hh,       Hh,       Hh,       Hh,       Hh,       Hh,       Hh,       Hh,       Hh,       Hh,       Hh,       Hh,       Hh,       Hh,       Hh,       Hh,       Hh,       Hh,       Hh,       Hh
    Gs^Fp,    Gs^Fp,    Gs^Fp,       Ce,       Ke,    Gs^Fp,    Gs^Fp,       Gg,       Rr,       Rr,       Gg,       Gg,       Gg,       Gg,       Gg,       Gg,       Hh,       Hh,       Hh,       Hh,       Hh,       Hh,       Hh,       Hh,       Hh,       Hh,       Hh,       Hh,       Hh,       Hh,       Hh,       Hh,       Hh,       Hh,       Hh,       Hh,       Hh,       Hh,       Hh
