
border_size=1
usage=map

       Ha,       Ha,       Ai,       Ai,       Ai,       Ai,       Ai,       Ai,       Ai,       Ai,       Ai,       Ai,   Aa^Fpa,   Aa^Fpa,   Aa^Fpa,   Aa^Fpa,   Aa^Fpa,   Aa^Fpa,   Aa^Fpa,   Aa^Fpa,   Aa^Fpa,   Aa^Fpa,   Aa^Fpa,   Aa^Fpa,   Aa^Fpa,   Aa^Fpa,   Aa^Fpa,   Aa^Fpa,    Gg^Ve,   Aa^Fpa,   Aa^Fpa,   Aa^Fpa,   Aa^Fpa,   Aa^Fpa,   Aa^Fpa,   Aa^Fpa,   Aa^Fpa,   Aa^Fpa,   Aa^Fpa,   Aa^Fpa,   Aa^Fpa,   Aa^Fpa,   Aa^Fpa,   Aa^Fpa,   Aa^Fpa,   Aa^Fpa,   Aa^Fpa,   Aa^Fpa,   Aa^Fpa,       Ha,       Ha,       Ha,       Ha,       Ha,       Ha,       Ha,       Ha,       Ha,       Ha,       Ha,       Ha
       Ha,       Ha,       Ai,       Ai,       Ai,       Ai,       Ai,       Ai,       Ai,       Ai,       Ai,       Ai,   Aa^Fpa,   Aa^Fpa,   Aa^Fpa,   Aa^Fpa,   Aa^Fpa,   Aa^Fpa,   Aa^Fpa,   Aa^Fpa,   Aa^Fpa,   Aa^Fpa,   Aa^Fpa,   Aa^Fpa,   Aa^Fpa,   Aa^Fpa,   Aa^Fpa,   Aa^Fpa,    Gg^Ve,   Aa^Fpa,   Aa^Fpa,   Aa^Fpa,   Aa^Fpa,   Aa^Fpa,   Aa^Fpa,   Aa^Fpa,   Aa^Fpa,   Aa^Fpa,   Aa^Fpa,   Aa^Fpa,   Aa^Fpa,   Aa^Fpa,   Aa^Fpa,   Aa^Fpa,   Aa^Fpa,   Aa^Fpa,   Aa^Fpa,   Aa^Fpa,   Aa^Fpa,       Ha,       Ha,       Ha,       Ha,       Ha,       Ha,       Ha,       Ha,       Ha,       Ha,       Ha,       Ha
       Ai,       Ai,       Ai,       Ai,       Ha,       Ha,       Ai,       Ai,       Ai,       Ai,       Ai,       Ai,       Ai,       Ai,   Aa^Fpa,   Aa^Fpa,   Aa^Fpa,   Aa^Fpa,   Aa^Fpa,   Aa^Fpa,   Aa^Fpa,   Aa^Fpa,   Aa^Fpa,   Aa^Fpa,   Aa^Fpa,   Aa^Fpa,   Aa^Fpa,   Aa^Fpa,   Aa^Fpa,   Aa^Fpa,   Aa^Fpa,   Aa^Fpa,   Aa^Fpa,   Aa^Fpa,   Aa^Fpa,   Aa^Fpa,   Aa^Fpa,   Aa^Fpa,   Aa^Fpa,   Aa^Fpa,   Aa^Fpa,   Aa^Fpa,   Aa^Fpa,       Ai,       Ai,       Ai,       Ha,       Ha,       Ha,       Ha,       Ha,       Ha,       Ha,       Ha,       Ha,       Ha,       Ha,       Ha,       Ha,       Ha,       Ha
       Ai,       Ai,       Ha,       Ha,       Ha,       Ha,       Ai,       Ai,       Ai,       Ai,       Ai,       Ai,       Ai,       Ai,       Ai,       Ai,       Ai,       Ai,   Aa^Fpa,    Gg^Ve,   Aa^Fpa,   Aa^Fpa,   Aa^Fpa,   Aa^Fpa,   Aa^Fpa,   Aa^Fpa,    Gg^Ve,   Aa^Fpa,   Aa^Fpa,   Aa^Fpa,   Aa^Fpa,   Aa^Fpa,   Aa^Fpa,   Aa^Fpa,   Aa^Fpa,   Aa^Fpa,       Ai,       Ai,       Ai,       Ai,       Ai,       Ai,       Ha,       Ha,       Ha,       Ha,       Ha,       Ha,       Ha,       Ha,       Ha,       Ha,       Ha,       Ha,       Ha,       Ha,       Ha,       Ha,       Ha,       Ha,       Ha
       Ai,       Ai,       Ai,       Ha,       Ha,       Ai,       Ai,       Ai,       Ai,       Ai,       Ai,       Ai,       Ai,       Ai,       Ai,       Ai,       Ai,   Aa^Fpa,   Aa^Fpa,   Aa^Fpa,   Aa^Fpa,   Aa^Fpa,   Aa^Fpa,   Aa^Fpa,   Aa^Fpa,   Aa^Fpa,   Aa^Fpa,   Aa^Fpa,   Aa^Fpa,   Aa^Fpa,   Aa^Fpa,    Gg^Ve,   Aa^Fpa,   Aa^Fpa,   Aa^Fpa,   Aa^Fpa,   Aa^Fpa,   Aa^Fpa,       Ai,       Ha,       Ha,       Ha,       Ha,       Ha,       Ha,       Ha,       Ha,       Ha,       Ha,       Ha,       Ha,       Ha,       Ha,       Ha,       Ha,       Ha,       Ha,       Ha,       Mm,       Mm,       Mm
       Ai,       Ai,       Ai,       Ai,       Ai,       Ce,       Ce,       Ai,       Ai,       Ai,       Ai,       Ai,       Ai,       Ai,       Ai,       Ai,       Ai,       Ai,   Aa^Fpa,   Aa^Fpa,   Aa^Fpa,   Aa^Fpa,   Aa^Fpa,   Aa^Fpa,   Aa^Fpa,   Aa^Fpa,   Aa^Fpa,   Aa^Fpa,   Aa^Fpa,   Aa^Fpa,   Aa^Fpa,   Aa^Fpa,   Aa^Fpa,   Aa^Fpa,   Aa^Fpa,   Aa^Fpa,       Ai,       Ha,       Ha,       Ha,       Ha,       Ha,       Ha,       Ha,       Ha,       Ha,       Ha,       Ha,       Ha,       Ha,       Ha,       Ha,       Ha,       Ha,       Ha,       Ha,       Ha,       Mm,       Mm,       Mm,       Mm
       Ai,       Ai,       Ai,       Ai,       Ai,       Ce,     2 Ke,       Ce,       Ai,       Ai,       Ai,       Ai,       Ai,       Ai,       Ai,       Ai,       Ai,       Ai,   Aa^Fpa,   Aa^Fpa,   Aa^Fpa,   Aa^Fpa,   Aa^Fpa,       Ch,       Ch,       Ch,   Aa^Fpa,   Aa^Fpa,   Aa^Fpa,   Aa^Fpa,    Gg^Ve,   Aa^Fpa,   Aa^Fpa,   Aa^Fpa,   Aa^Fpa,       Ai,       Ai,       Ai,       Ai,       Ha,       Ha,       Ha,       Ha,       Ce,       Ce,       Ce,       Ha,       Ha,       Ha,       Ha,       Ha,       Ha,       Ha,       Ha,       Ha,       Ha,       Mm,       Mm,       Mm,       Mm,       Mm
       Ai,       Ai,       Ai,       Ai,       Ai,       Ai,       Ai,       Ai,       Ce,       Ce,       Ai,       Ai,       Ai,       Ai,       Ai,       Ai,       Ai,       Ai,       Ai,   Aa^Fpa,   Aa^Fpa,   Aa^Fpa,   Aa^Fpa,       Ch,     5 Kh,       Ch,   Aa^Fpa,   Aa^Fpa,   Aa^Fpa,   Aa^Fpa,   Aa^Fpa,   Aa^Fpa,   Aa^Fpa,   Aa^Fpa,       Ai,       Ai,       Ha,       Ha,       Ha,       Ha,       Ha,       Ha,       Ha,       Ce,     3 Ke,       Ce,       Ha,       Ha,       Ha,       Ha,       Ha,       Ha,       Ha,       Ha,       Ha,       Mm,       Mm,       Mm,       Mm,       Mm,       Mm
       Ai,       Ai,       Ai,       Ai,       Ai,       Ai,       Ai,    Gg^Vh,       Ai,       Ai,       Ai,       Ai,       Ai,       Ai,       Ai,       Ai,       Ai,       Ai,   Aa^Fpa,   Aa^Fpa,   Aa^Fpa,   Aa^Fpa,   Aa^Fpa,   Aa^Fpa,       Ch,   Aa^Fpa,   Aa^Fpa,   Aa^Fpa,    Gg^Ve,   Aa^Fpa,   Aa^Fpa,   Aa^Fpa,   Aa^Fpa,   Aa^Fpa,       Ai,       Ai,       Ha,       Ha,       Ha,       Ha,       Ha,       Ha,       Ha,       Ha,       Ce,       Ce,       Ha,       Ha,    Gg^Ve,       Ha,       Ha,       Ha,       Ha,       Ha,       Ha,       Ha,       Mm,       Mm,       Mm,       Mm,       Mm
       Ai,       Ai,       Ai,       Ai,       Ai,       Ai,       Ai,       Ai,       Ai,       Ai,       Ai,       Ai,       Ai,       Ai,       Ai,       Ai,   Aa^Fpa,   Aa^Fpa,   Aa^Fpa,   Aa^Fpa,   Aa^Fpa,   Aa^Fpa,   Aa^Fpa,   Aa^Fpa,   Aa^Fpa,   Aa^Fpa,   Aa^Fpa,   Aa^Fpa,   Aa^Fpa,   Aa^Fpa,   Aa^Fpa,   Aa^Fpa,   Aa^Fpa,   Aa^Fpa,   Aa^Fpa,   Aa^Fpa,    Gg^Ve,   Aa^Fpa,       Ai,       Ai,       Ai,       Ai,       Ha,       Ha,       Ha,       Ha,       Ha,       Ha,       Ha,       Ha,       Ha,       Ha,       Ha,       Ha,       Ha,       Ha,       Ha,       Ha,       Mm,       Mm,       Mm
       Ai,       Ai,       Ai,       Ai,       Ai,       Ai,       Ai,       Ai,       Ai,       Ai,       Ai,       Ai,       Ai,       Ai,       Ai,   Aa^Fpa,   Aa^Fpa,   Aa^Fpa,   Aa^Fpa,   Aa^Fpa,   Aa^Fpa,   Aa^Fpa,   Aa^Fpa,    Gg^Ve,   Aa^Fpa,   Aa^Fpa,   Aa^Fpa,   Aa^Fpa,   Aa^Fpa,   Aa^Fpa,   Aa^Fpa,   Aa^Fpa,   Aa^Fpa,   Aa^Fpa,   Aa^Fpa,   Aa^Fpa,   Aa^Fpa,       Ai,       Ai,       Ai,       Ai,       Ai,       Ai,       Ai,       Ai,       Ha,       Ha,       Ha,       Ha,       Ha,       Ha,       Ha,       Ha,       Ha,       Ha,       Ha,       Ha,       Ha,       Mm,       Mm,       Mm
       Ai,       Ai,       Ai,       Ai,       Ai,       Ai,       Ai,       Ai,       Ai,       Ai,       Ai,    Gg^Vh,       Ai,       Ai,       Ai,       Ai,   Aa^Fpa,   Aa^Fpa,   Aa^Fpa,   Aa^Fpa,   Aa^Fpa,   Aa^Fpa,   Aa^Fpa,   Aa^Fpa,   Aa^Fpa,   Aa^Fpa,   Aa^Fpa,   Aa^Fpa,   Aa^Fpa,   Aa^Fpa,   Aa^Fpa,   Aa^Fpa,   Aa^Fpa,   Aa^Fpa,   Aa^Fpa,   Aa^Fpa,   Aa^Fpa,       Ai,       Ai,       Ai,       Ai,       Ha,       Ha,       Ha,       Ha,       Ha,       Ha,       Ha,       Ha,       Ha,       Ha,       Ha,       Ha,       Ha,       Ha,       Mm,       Mm,       Mm,       Mm,       Mm,       Mm
       Ai,       Ai,       Ai,    Gg^Vh,       Ai,       Ai,       Ai,       Ai,       Ai,       Ai,       Ai,       Ai,       Ai,       Ai,       Ai,       Ai,       Ai,   Aa^Fpa,   Aa^Fpa,   Aa^Fpa,   Aa^Fpa,   Aa^Fpa,   Aa^Fpa,   Aa^Fpa,   Aa^Fpa,   Aa^Fpa,   Aa^Fpa,   Aa^Fpa,   Aa^Fpa,   Aa^Fpa,   Aa^Fpa,   Aa^Fpa,   Aa^Fpa,   Aa^Fpa,   Aa^Fpa,   Aa^Fpa,    Gg^Ve,       Ai,       Ai,       Ai,       Ha,       Ha,       Ha,       Ha,       Ha,       Ha,       Ha,       Ha,       Ha,       Ha,       Mm,       Mm,       Mm,       Mm,       Mm,       Mm,       Mm,       Mm,       Mm,       Mm,       Mm
       Ai,       Ai,       Ai,       Ai,       Ai,       Ai,       Ai,       Ai,       Ai,       Ai,       Ai,       Ai,       Ai,       Ai,       Ai,       Ai,       Ai,       Ai,       Ai,   Aa^Fpa,   Aa^Fpa,   Aa^Fpa,   Aa^Fpa,   Aa^Fpa,   Aa^Fpa,   Aa^Fpa,   Aa^Fpa,   Aa^Fpa,   Aa^Fpa,   Aa^Fpa,   Aa^Fpa,    Gg^Ve,   Aa^Fpa,   Aa^Fpa,   Aa^Fpa,   Aa^Fpa,   Aa^Fpa,   Aa^Fpa,       Ai,       Ai,       Ai,       Ha,       Ha,       Ha,       Ha,       Ha,       Ha,       Ha,       Ha,       Ha,       Ha,       Ha,       Ha,       Mm,       Mm,       Mm,       Mm,       Mm,       Mm,       Mm,       Mm
       Ai,       Ai,       Ai,       Ai,       Ai,       Ai,       Ai,       Ai,       Ai,       Ai,       Ai,       Ai,       Ai,       Ai,       Ai,       Ai,       Ai,       Ai,   Aa^Fpa,   Aa^Fpa,   Aa^Fpa,   Aa^Fpa,   Aa^Fpa,   Aa^Fpa,   Aa^Fpa,   Aa^Fpa,    Gg^Ve,   Aa^Fpa,   Aa^Fpa,   Aa^Fpa,   Aa^Fpa,   Aa^Fpa,   Aa^Fpa,   Aa^Fpa,    Gg^Ve,   Aa^Fpa,   Aa^Fpa,   Aa^Fpa,       Ai,       Ai,       Ai,       Ai,       Ai,       Ai,       Ai,       Ai,       Ai,       Ha,       Ha,       Ha,       Ha,       Ha,       Ha,       Ha,       Mm,       Mm,       Mm,       Mm,       Mm,       Mm,       Mm
       Aa,       Aa,       Aa,       Ai,       Ai,       Ai,       Ai,       Ai,       Ai,       Ai,       Ai,    Gg^Vh,       Ai,       Ai,       Ai,       Ai,       Ai,   Aa^Fpa,   Aa^Fpa,   Aa^Fpa,   Aa^Fpa,   Aa^Fpa,   Aa^Fpa,   Aa^Fpa,   Aa^Fpa,   Aa^Fpa,   Aa^Fpa,   Aa^Fpa,   Aa^Fpa,   Aa^Fpa,    Gg^Ve,   Aa^Fpa,   Aa^Fpa,   Aa^Fpa,   Aa^Fpa,   Aa^Fpa,   Aa^Fpa,   Aa^Fpa,   Aa^Fpa,       Ai,       Ai,       Ai,       Ai,       Ai,       Ai,       Ai,       Ai,       Ai,       Ai,       Ai,       Ha,       Ha,       Ha,       Ha,       Ha,       Mm,       Mm,       Mm,       Ww,       Ww,       Ww
       Aa,       Aa,       Aa,       Aa,       Aa,       Aa,       Ai,       Ai,       Ai,       Ai,       Ai,       Ai,       Ai,       Ai,       Ai,       Ai,       Ai,       Ai,   Aa^Fpa,   Aa^Fpa,   Aa^Fpa,   Aa^Fpa,   Aa^Fpa,   Aa^Fpa,   Aa^Fpa,   Aa^Fpa,   Aa^Fpa,   Aa^Fpa,   Aa^Fpa,   Aa^Fpa,   Aa^Fpa,   Aa^Fpa,   Aa^Fpa,   Aa^Fpa,   Aa^Fpa,   Aa^Fpa,   Aa^Fpa,   Aa^Fpa,   Aa^Fpa,       Ai,       Ai,       Ai,       Ai,       Ai,       Ai,       Ai,       Ai,       Ai,       Ai,       Ai,       Ha,       Ha,       Ha,       Ha,       Ha,       Ha,       Ha,       Ww,       Ww,       Mm,       Mm
       Aa,       Aa,       Aa,       Aa,       Aa,       Aa,       Ai,       Ai,       Ai,       Ai,       Ai,       Ai,       Ai,       Ai,       Ai,       Ai,       Ai,   Aa^Fpa,   Aa^Fpa,   Aa^Fpa,   Aa^Fpa,    Gg^Ve,   Aa^Fpa,   Aa^Fpa,   Aa^Fpa,   Aa^Fpa,   Aa^Fpa,   Aa^Fpa,   Aa^Fpa,   Aa^Fpa,   Aa^Fpa,   Aa^Fpa,   Aa^Fpa,   Aa^Fpa,   Aa^Fpa,   Aa^Fpa,   Aa^Fpa,   Aa^Fpa,   Aa^Fpa,   Aa^Fpa,   Aa^Fpa,       Ai,       Ai,       Ai,       Ai,       Ai,       Ai,       Ai,       Ai,       Ai,       Ha,       Ha,       Ha,       Ha,       Ha,       Ww,       Ww,       Ww,       Mm,       Mm,       Mm
       Aa,       Aa,       Aa,       Aa,       Ai,       Ai,       Ai,       Ai,       Ai,       Ai,       Ai,       Ai,       Ai,       Ai,       Ai,       Ai,       Ai,       Ai,   Aa^Fpa,   Aa^Fpa,   Aa^Fpa,   Aa^Fpa,   Aa^Fpa,   Aa^Fpa,   Aa^Fpa,   Aa^Fpa,   Aa^Fpa,   Aa^Fpa,   Aa^Fpa,   Aa^Fpa,   Aa^Fpa,   Aa^Fpa,   Aa^Fpa,   Aa^Fpa,   Aa^Fpa,   Aa^Fpa,   Aa^Fpa,   Aa^Fpa,   Aa^Fpa,   Aa^Fpa,       Ai,       Ai,       Ai,       Ai,       Ai,       Ai,       Ai,       Ai,       Ai,       Ai,       Ai,       Ai,       Ha,       Ww,       Ww,       Ww,       Mm,       Mm,       Mm,       Mm,       Mm
       Aa,       Aa,       Aa,       Aa,       Aa,       Ai,       Ai,       Ai,       Ai,       Ai,       Ai,       Ai,    Gg^Vh,       Ai,       Ai,       Ai,       Ai,       Ai,       Ai,   Aa^Fpa,   Aa^Fpa,   Aa^Fpa,   Aa^Fpa,   Aa^Fpa,   Aa^Fpa,   Aa^Fpa,   Aa^Fpa,   Aa^Fpa,   Aa^Fpa,   Aa^Fpa,   Aa^Fpa,   Aa^Fpa,   Aa^Fpa,   Aa^Fpa,   Aa^Fpa,   Aa^Fpa,   Aa^Fpa,   Aa^Fpa,   Aa^Fpa,   Aa^Fpa,   Aa^Fpa,       Ai,       Ai,       Ai,       Ai,       Ai,       Ai,       Ai,       Ai,       Ai,       Ww,       Ww,       Ww,       Ww,       Mm,       Mm,       Mm,       Mm,       Mm,       Mm,       Mm
       Aa,       Aa,       Ai,       Ai,       Ai,       Ai,       Ai,       Ai,       Ai,       Ai,       Ai,       Ai,       Ai,       Ai,       Ai,       Ai,       Ai,       Ai,       Ai,       Ai,   Aa^Fpa,   Aa^Fpa,   Aa^Fpa,   Aa^Fpa,   Aa^Fpa,   Aa^Fpa,   Aa^Fpa,   Aa^Fpa,   Aa^Fpa,   Aa^Fpa,   Aa^Fpa,   Aa^Fpa,   Aa^Fpa,   Aa^Fpa,   Aa^Fpa,    Gg^Ve,   Aa^Fpa,   Aa^Fpa,   Aa^Fpa,   Aa^Fpa,   Aa^Fpa,       Ai,       Ai,       Ai,       Ai,       Ai,       Ai,       Ai,       Ww,       Ww,       Ww,       Ww,       Ww,       Mm,       Mm,       Mm,       Mm,       Mm,       Mm,       Mm,       Mm
       Aa,       Aa,       Aa,       Aa,       Ai,       Ai,       Ai,       Ai,       Ai,       Ai,       Ai,       Ai,       Ai,       Ai,       Ai,       Ai,       Ai,       Ai,       Ai,   Aa^Fpa,   Aa^Fpa,   Aa^Fpa,   Aa^Fpa,   Aa^Fpa,   Aa^Fpa,   Aa^Fpa,   Aa^Fpa,   Aa^Fpa,   Aa^Fpa,   Aa^Fpa,   Aa^Fpa,   Aa^Fpa,   Aa^Fpa,   Aa^Fpa,   Aa^Fpa,   Aa^Fpa,   Aa^Fpa,   Aa^Fpa,   Aa^Fpa,   Aa^Fpa,   Aa^Fpa,       Ai,       Ai,       Ai,       Ai,       Ai,       Ai,       Ww,       Ww,       Ww,       Ww,       Ai,       Ha,       Ha,       Ha,       Mm,       Mm,       Mm,       Mm,       Mm,       Mm
       Ai,       Ai,       Ai,       Ai,       Ai,       Ai,       Ai,       Ai,       Ai,       Ai,       Ai,       Ai,       Ai,       Ai,       Ai,       Ai,       Ai,    Gg^Vh,       Ai,       Ai,   Aa^Fpa,   Aa^Fpa,   Aa^Fpa,   Aa^Fpa,   Aa^Fpa,   Aa^Fpa,   Aa^Fpa,   Aa^Fpa,   Aa^Fpa,   Aa^Fpa,   Aa^Fpa,   Aa^Fpa,   Aa^Fpa,   Aa^Fpa,   Aa^Fpa,   Aa^Fpa,   Aa^Fpa,   Aa^Fpa,   Aa^Fpa,   Aa^Fpa,   Aa^Fpa,   Aa^Fpa,       Ai,       Ai,       Ai,       Ai,       Ww,       Ww,       Ai,       Ai,       Ai,       Ha,       Ha,       Ha,       Mm,       Mm,       Mm,       Mm,       Mm,       Mm,       Mm
       Ai,       Ai,       Ai,       Ai,       Ai,       Ai,       Ai,       Ai,       Ai,       Ai,       Ai,       Ai,       Ai,       Ai,       Ai,       Ai,       Ai,       Ai,       Ai,       Ai,       Ai,   Aa^Fpa,   Aa^Fpa,   Aa^Fpa,   Aa^Fpa,   Aa^Fpa,   Aa^Fpa,   Aa^Fpa,   Aa^Fpa,   Aa^Fpa,   Aa^Fpa,   Aa^Fpa,   Aa^Fpa,   Aa^Fpa,   Aa^Fpa,   Aa^Fpa,   Aa^Fpa,   Aa^Fpa,   Aa^Fpa,   Aa^Fpa,   Aa^Fpa,   Aa^Fpa,   Aa^Fpa,       Ww,       Ww,       Ai,       Ai,       Ai,       Ai,       Ai,       Ai,       Ha,       Ha,       Ha,       Mm,       Mm,       Mm,       Mm,       Mm,       Mm,       Mm
       Ai,       Ai,       Ai,       Ai,       Ai,       Ai,       Ai,       Ai,       Ai,    Gg^Vh,       Ai,       Ai,       Ai,       Ai,       Ai,       Ai,       Ai,       Ai,       Ai,       Ai,       Ai,       Ai,   Aa^Fpa,   Aa^Fpa,   Aa^Fpa,   Aa^Fpa,   Aa^Fpa,   Aa^Fpa,   Aa^Fpa,   Aa^Fpa,   Aa^Fpa,   Aa^Fpa,   Aa^Fpa,   Aa^Fpa,   Aa^Fpa,   Aa^Fpa,   Aa^Fpa,   Aa^Fpa,   Aa^Fpa,   Aa^Fpa,   Aa^Fpa,       Ww,       Ww,   Aa^Fpa,       Ai,       Ai,       Ai,       Ai,       Ai,       Ai,       Ai,       Ai,       Ha,       Ha,       Ha,       Mm,       Mm,       Mm,       Mm,       Mm,       Mm
       Ai,       Ai,       Ai,       Ai,       Ai,       Ai,       Ai,       Ai,       Ai,       Ai,       Ai,       Ai,       Ai,       Ai,       Ai,       Ai,       Ai,       Ai,       Ai,       Ai,       Ai,       Ai,       Ai,   Aa^Fpa,   Aa^Fpa,   Aa^Fpa,    Gg^Ve,   Aa^Fpa,   Aa^Fpa,   Aa^Fpa,   Aa^Fpa,   Aa^Fpa,   Aa^Fpa,   Aa^Fpa,   Aa^Fpa,   Aa^Fpa,   Aa^Fpa,   Aa^Fpa,    Gg^Ve,       Ww,       Ww,   Aa^Fpa,   Aa^Fpa,   Aa^Fpa,   Aa^Fpa,   Aa^Fpa,   Aa^Fpa,       Ai,       Ai,       Ai,       Ai,       Ai,       Ai,       Ha,       Ha,       Ha,       Mm,       Mm,       Mm,       Mm,       Mm
    Gg^Vh,    Gg^Vh,       Ai,       Ai,       Ai,       Ai,       Ai,       Ai,       Ai,       Ai,       Ai,       Ai,       Ai,       Ai,       Ai,       Ai,       Ai,       Ai,       Ai,       Ai,       Ai,       Ai,       Ai,       Ai,   Aa^Fpa,   Aa^Fpa,   Aa^Fpa,   Aa^Fpa,   Aa^Fpa,   Aa^Fpa,   Aa^Fpa,   Aa^Fpa,   Aa^Fpa,   Aa^Fpa,   Aa^Fpa,   Aa^Fpa,   Aa^Fpa,       Ww,       Ww,   Aa^Fpa,   Aa^Fpa,   Aa^Fpa,   Aa^Fpa,   Aa^Fpa,   Aa^Fpa,   Aa^Fpa,   Aa^Fpa,   Aa^Fpa,       Ai,       Ai,       Ai,       Ai,       Ha,       Ha,       Ha,       Ha,       Mm,       Mm,       Mm,       Mm,       Mm
       Ai,       Ai,       Ai,       Ai,       Ai,       Ai,       Ai,       Ai,       Ai,       Ai,       Ai,    Gg^Ve,       Ai,       Ai,       Ai,       Ai,       Ai,       Ai,       Ai,       Ai,       Ai,       Ai,       Ai,   Aa^Fpa,   Aa^Fpa,   Aa^Fpa,   Aa^Fpa,   Aa^Fpa,   Aa^Fpa,   Aa^Fpa,   Aa^Fpa,   Aa^Fpa,   Aa^Fpa,   Aa^Fpa,   Aa^Fpa,   Aa^Fpa,       Ww,       Ww,   Aa^Fpa,   Aa^Fpa,   Aa^Fpa,   Aa^Fpa,   Aa^Fpa,   Aa^Fpa,   Aa^Fpa,       Ai,       Ai,       Ai,       Ai,       Ai,       Ai,       Ai,       Ai,       Ai,       Ha,       Ha,       Ha,       Ha,       Ha,       Mm,       Mm
       Ai,       Ai,       Ai,       Ai,       Ai,       Ai,       Ai,       Ai,       Ai,       Ai,       Ai,       Ai,       Ai,       Ai,       Ai,       Ai,       Ai,       Ai,       Ai,       Ai,       Ai,       Ai,       Ai,       Ai,   Aa^Fpa,   Aa^Fpa,   Aa^Fpa,   Aa^Fpa,   Aa^Fpa,   Aa^Fpa,   Aa^Fpa,   Aa^Fpa,   Aa^Fpa,   Aa^Fpa,       Ww,       Ww,   Aa^Fpa,   Aa^Fpa,   Aa^Fpa,   Aa^Fpa,   Aa^Fpa,   Aa^Fpa,   Aa^Fpa,   Aa^Fpa,       Ai,       Ai,       Ai,       Ai,       Ai,       Ai,       Ai,       Ha,       Ha,       Ha,       Ha,       Mm,       Mm,       Mm,       Mm,       Mm,       Mm
       Ai,       Ai,       Ai,       Ai,       Ai,       Ai,       Ai,       Ai,       Ai,       Ai,       Ai,       Ai,       Ai,       Ai,       Ai,       Ai,    Gg^Vh,       Ai,       Ai,       Ai,       Ai,       Ai,       Ai,       Ai,       Ai,       Ai,       Ai,   Aa^Fpa,   Aa^Fpa,   Aa^Fpa,   Aa^Fpa,   Aa^Fpa,       Ww,       Ww,   Aa^Fpa,   Aa^Fpa,   Aa^Fpa,   Aa^Fpa,   Aa^Fpa,   Aa^Fpa,   Aa^Fpa,   Aa^Fpa,   Aa^Fpa,   Aa^Fpa,       Ai,       Ai,       Ai,       Ai,    Gg^Ve,       Ai,       Ha,       Ha,       Ha,       Ha,       Ha,       Mm,       Mm,       Mm,       Mm,       Mm,       Mm
       Ai,       Ai,       Ai,       Ai,       Ai,       Ai,       Ai,       Ai,       Ai,       Ai,       Ai,       Ai,       Ai,       Ai,       Ai,       Ai,       Ai,       Ai,       Ai,       Ai,       Ai,       Ai,       Ai,       Ai,       Ai,       Ai,   Aa^Fpa,   Aa^Fpa,   Aa^Fpa,   Aa^Fpa,       Ww,       Ww,   Aa^Fpa,   Aa^Fpa,   Aa^Fpa,   Aa^Fpa,   Aa^Fpa,   Aa^Fpa,   Aa^Fpa,   Aa^Fpa,   Aa^Fpa,   Aa^Fpa,   Aa^Fpa,   Aa^Fpa,       Ai,       Ai,       Ai,       Ai,       Ai,       Ai,       Ai,       Ai,       Ai,       Ai,       Ha,       Ha,       Ha,       Ha,       Mm,       Mm,       Mm
       Ai,       Ai,       Ai,       Ai,       Ai,       Ai,       Ai,    Gg^Vh,       Ai,       Ai,       Ai,       Ai,       Ai,       Ai,       Ai,       Ai,       Ai,       Ai,       Ai,       Ai,       Ai,       Ai,       Ai,       Ai,       Ai,       Ai,       Ai,       Ai,       Ww,       Ww,   Aa^Fpa,   Aa^Fpa,   Aa^Fpa,   Aa^Fpa,   Aa^Fpa,    Gg^Ve,   Aa^Fpa,   Aa^Fpa,   Aa^Fpa,       Ai,       Ai,       Ai,       Ai,       Ai,       Ai,       Ai,       Ai,       Ai,       Ai,       Ai,       Ai,       Ai,       Ai,       Ai,       Ha,       Ha,       Ha,       Ha,       Mm,       Mm,       Mm
       Ai,       Ai,       Ai,       Ai,       Ai,       Ai,       Ai,       Ai,       Ai,       Ai,       Ai,       Ai,       Ai,       Ai,       Ai,       Ai,       Ai,       Ai,       Ai,       Ai,       Ai,       Ai,       Ai,       Ai,       Ai,       Ai,       Ai,       Ai,       Ww,       Ww,       Ai,       Ai,       Ai,       Ai,   Aa^Fpa,       Ai,       Ai,       Ai,       Ai,       Ai,       Ai,       Ai,       Ai,       Ai,       Ai,       Ai,       Ai,       Ai,       Ai,       Ai,       Ai,       Ai,       Ai,       Ai,       Ha,       Ha,       Ha,       Ha,       Mm,       Mm,       Mm
       Ww,       Ww,       Ai,       Ai,       Ai,       Ai,       Ai,       Ai,       Ai,       Ai,       Ai,       Ai,       Ai,       Ai,       Ai,       Ai,       Ai,       Ai,       Ai,       Ai,       Ai,       Ai,       Ai,       Ai,       Ai,       Ai,       Ai,       Ww,       Ai,       Ai,       Ai,       Ai,       Ai,       Ai,       Ai,       Ai,       Ai,       Ai,       Ai,       Ai,       Ai,       Ai,       Ai,       Ai,       Ai,       Ai,       Ai,       Ai,       Ai,       Ai,       Ai,       Ai,       Ha,       Ha,       Ha,       Mm,       Mm,       Mm,       Mm,       Mm,       Mm
       Ai,       Ai,       Ww,       Ww,       Ai,       Ai,       Ai,       Ai,       Ai,       Ai,       Ai,       Ai,       Ai,       Ai,       Ai,       Ww,   Ww^Bw|,       Ww,       Ww,       Ww,       Ai,       Ai,       Ai,       Ai,       Ai,       Ww,       Ww,       Ai,       Ai,       Ai,       Ai,       Ai,       Ai,       Ai,       Ai,       Ai,       Ai,       Ai,       Ai,       Ai,       Ai,       Ai,       Ai,       Ai,       Ai,       Ai,       Ai,       Ai,       Ai,       Ai,       Ai,       Ai,       Ha,       Ha,       Ha,       Ha,       Mm,       Mm,       Mm,       Mm,       Mm
       Ai,       Ai,       Ai,       Ai,       Ww,       Ww,       Ai,       Ai,       Ai,       Ai,       Ai,       Ai,       Ai,       Ww,       Ww,       Ai,       Ai,       Ai,       Ai,       Ai,       Ww,       Ww,       Ai,       Ww,       Ww,       Ai,       Ai,       Ai,       Ai,       Ai,       Ai,       Ai,       Ai,       Ai,       Ai,       Ai,       Ai,       Ai,       Ai,       Ai,       Ai,       Ai,       Ai,       Ai,       Ai,       Ha,       Ha,       Ha,    Gg^Ve,       Ha,       Ha,       Ha,       Ha,       Ha,       Ha,       Ha,       Ha,       Mm,       Mm,       Mm,       Mm
       Ai,       Ai,       Ai,       Ai,       Ai,       Ai,       Ww,       Ww,       Ai,       Ai,       Ai,       Ww,       Ww,       Ai,       Ai,       Ai,       Ai,       Ai,       Ai,       Ai,       Ai,       Ai,       Ww,    Gg^Vh,       Ai,       Ai,       Ai,       Ai,       Ai,       Ai,       Ai,       Ai,       Ai,       Ai,       Ai,       Ai,       Ai,       Ai,       Ai,       Ai,       Ai,       Ai,       Ai,       Ai,       Ai,       Ai,       Ai,       Ai,       Ai,       Ai,       Ha,       Ha,       Ha,       Ha,       Ha,    Gg^Ve,       Mm,       Mm,       Mm,       Mm,       Mm
       Ai,       Ai,       Ai,       Ai,       Ai,       Ai,       Ai,       Ai,       Ww,       Ww,       Ww,       Ai,       Ai,       Ai,       Ai,       Ce,       Rr,       Rr,       Rr,       Rr,       Ai,       Ai,       Ai,       Ai,       Ai,       Ai,       Ai,       Ai,       Ai,       Ai,       Ai,       Ai,       Ai,       Ai,       Ai,       Ai,       Ai,       Ai,       Ai,       Ai,       Ai,       Ai,       Ai,       Ai,       Ai,       Ai,       Ai,       Ai,       Ai,       Ai,       Ha,       Ha,       Ha,       Ha,       Ha,       Mm,       Mm,       Mm,       Mm,       Mm,       Mm
       Ai,       Ai,       Ai,       Ai,       Ai,       Ai,    Gg^Vh,       Ai,       Ai,       Ai,       Ai,       Ai,    Gg^Vh,       Rr,       Ce,     4 Ke,       Ce,       Ai,       Ai,       Ai,       Rr,       Rr,       Rr,       Rr,       Ai,       Ai,       Ai,       Ai,       Ai,       Ai,       Ai,       Ai,       Ai,       Ai,       Ai,       Ai,       Ai,       Ai,       Ai,       Ai,       Ai,       Ai,       Ai,       Ai,       Ai,       Ce,       Ce,       Ce,       Ce,       Ai,       Ha,       Ha,       Ha,       Ha,       Ha,       Mm,       Mm,       Mm,       Mm,       Mm,       Mm
       Rr,       Rr,       Rr,       Rr,       Rr,       Rr,       Ai,       Ai,       Ai,       Ai,       Ai,       Rr,       Rr,       Ai,       Ce,       Ce,       Ce,       Ai,       Ai,       Ai,    Gg^Vh,       Ai,       Ai,       Ai,       Rr,       Rr,       Rr,       Rr,       Rr,       Ai,       Ai,       Ai,       Ai,       Ai,       Ai,       Ai,       Ai,       Ai,       Ai,       Ai,       Ai,       Ai,       Ai,       Ai,       Ai,       Ce,     1 Ke,       Ce,       Ai,       Ai,       Ai,       Ha,       Ha,       Ha,       Ha,       Ha,    Gg^Ve,       Mm,       Mm,       Mm,       Mm
    Gg^Vh,    Gg^Vh,       Ai,       Ai,       Ai,       Ai,       Rr,       Rr,       Rr,       Rr,       Rr,       Ai,       Ai,       Ai,       Ai,       Ai,       Ai,       Ai,       Ai,       Ai,       Ai,       Ai,       Ai,       Ai,       Ai,       Ai,       Ai,       Ai,       Ai,       Ai,       Ai,       Ai,       Ai,       Ai,       Ai,       Ai,       Ai,       Ai,       Ai,       Ai,       Ai,       Ai,       Ai,       Ai,       Ai,       Ai,       Ce,       Ai,       Ai,       Ai,       Ai,       Ha,       Ha,       Ha,       Ha,       Ha,       Ha,       Ha,       Mm,       Mm,       Mm
    Gg^Vh,    Gg^Vh,       Ai,       Ai,       Ai,       Ai,       Rr,       Rr,       Rr,       Rr,       Rr,       Ai,       Ai,       Ai,       Ai,       Ai,       Ai,       Ai,       Ai,       Ai,       Ai,       Ai,       Ai,       Ai,       Ai,       Ai,       Ai,       Ai,       Ai,       Ai,       Ai,       Ai,       Ai,       Ai,       Ai,       Ai,       Ai,       Ai,       Ai,       Ai,       Ai,       Ai,       Ai,       Ai,       Ai,       Ai,       Ce,       Ai,       Ai,       Ai,       Ai,       Ha,       Ha,       Ha,       Ha,       Ha,       Ha,       Ha,       Mm,       Mm,       Mm
