
border_size=1
usage=map

   Aa^Fpa,   Aa^Fpa,   Aa^Fpa,   Aa^Fpa,   Aa^Fpa,   Aa^Fpa,   Aa^Fpa,    Gg^Ve,   Aa^Fpa,   Aa^Fpa,   Aa^Fpa,   Aa^Fpa,   Aa^Fpa,   Aa^Fpa,   Aa^Fpa,   Aa^Fpa,   Aa^Fpa,   Aa^Fpa,   Aa^Fpa,   Aa^Fpa,   Aa^Fpa,   Aa^Fpa,   Aa^Fpa,   Aa^Fpa,   Aa^Fpa,   Aa^Fpa,   Aa^Fpa,   Aa^Fpa,   Aa^Fpa
   Aa^Fpa,   Aa^Fpa,   Aa^Fpa,   Aa^Fpa,   Aa^Fpa,   Aa^Fpa,   Aa^Fpa,    Gg^Ve,   Aa^Fpa,   Aa^Fpa,   Aa^Fpa,   Aa^Fpa,   Aa^Fpa,   Aa^Fpa,   Aa^Fpa,   Aa^Fpa,   Aa^Fpa,   Aa^Fpa,   Aa^Fpa,   Aa^Fpa,   Aa^Fpa,   Aa^Fpa,   Aa^Fpa,   Aa^Fpa,   Aa^Fpa,   Aa^Fpa,   Aa^Fpa,   Aa^Fpa,   Aa^Fpa
   Aa^Fpa,   Aa^Fpa,   Aa^Fpa,   Aa^Fpa,   Aa^Fpa,   Aa^Fpa,   Aa^Fpa,   Aa^Fpa,   Aa^Fpa,   Aa^Fpa,   Aa^Fpa,   Aa^Fpa,   Aa^Fpa,   Aa^Fpa,   Aa^Fpa,   Aa^Fpa,   Aa^Fpa,   Aa^Fpa,   Aa^Fpa,   Aa^Fpa,   Aa^Fpa,   Aa^Fpa,       Ai,       Ai,       Ai,       Ha,       Ha,       Ha,       Ha
   Aa^Fpa,   Aa^Fpa,   Aa^Fpa,   Aa^Fpa,   Aa^Fpa,    Gg^Ve,   Aa^Fpa,   Aa^Fpa,   Aa^Fpa,   Aa^Fpa,   Aa^Fpa,   Aa^Fpa,   Aa^Fpa,   Aa^Fpa,   Aa^Fpa,       Ai,       Ai,       Ai,       Ai,       Ai,       Ai,       Ha,       Ha,       Ha,       Ha,       Ha,       Ha,       Ha,       Ha
   Aa^Fpa,   Aa^Fpa,   Aa^Fpa,   Aa^Fpa,   Aa^Fpa,   Aa^Fpa,   Aa^Fpa,   Aa^Fpa,   Aa^Fpa,   Aa^Fpa,    Gg^Ve,   Aa^Fpa,   Aa^Fpa,   Aa^Fpa,   Aa^Fpa,   Aa^Fpa,   Aa^Fpa,       Ai,       Ha,       Ha,       Ha,       Ha,       Ha,       Ha,       Ha,       Ha,       Ha,       Ha,       Ha
   Aa^Fpa,   Aa^Fpa,   Aa^Fpa,   Aa^Fpa,   Aa^Fpa,   Aa^Fpa,   Aa^Fpa,   Aa^Fpa,   Aa^Fpa,   Aa^Fpa,   Aa^Fpa,   Aa^Fpa,   Aa^Fpa,   Aa^Fpa,   Aa^Fpa,       Ai,       Ha,       Ha,       Ha,       Ha,       Ha,       Ha,       Ha,       Ha,       Ha,       Ha,       Ha,       Ha,       Ha
   Aa^Fpa,   Aa^Fpa,       Ch,       Ch,       Ch,   Aa^Fpa,   Aa^Fpa,   Aa^Fpa,   Aa^Fpa,    Gg^Ve,   Aa^Fpa,   Aa^Fpa,   Aa^Fpa,   Aa^Fpa,       Ai,       Ai,       Ai,       Ai,       Ha,       Ha,       Ha,       Ha,       Ha,       Ha,       Ha,       Ha,       Ha,       Ha,       Ha
   Aa^Fpa,   Aa^Fpa,       Ch,     1 Kh,       Ch,   Aa^Fpa,   Aa^Fpa,   Aa^Fpa,   Aa^Fpa,   Aa^Fpa,   Aa^Fpa,   Aa^Fpa,   Aa^Fpa,       Ai,       Ai,       Ha,       Ha,       Ha,       Ha,       Ha,       Ha,       Ha,       Ha,       Ha,       Ha,       Ha,       Ha,       Ha,       Ha
   Aa^Fpa,   Aa^Fpa,   Aa^Fpa,       Ch,   Aa^Fpa,   Aa^Fpa,   Aa^Fpa,    Gg^Ve,   Aa^Fpa,   Aa^Fpa,   Aa^Fpa,   Aa^Fpa,   Aa^Fpa,       Ai,       Ai,       Ha,       Ha,       Ha,       Ha,       Ha,       Ha,       Ha,       Ha,       Ce,       Ce,       Ha,       Ha,    Gg^Ve,    Gg^Ve
   Aa^Fpa,   Aa^Fpa,   Aa^Fpa,   Aa^Fpa,   Aa^Fpa,   Aa^Fpa,   Aa^Fpa,   Aa^Fpa,   Aa^Fpa,   Aa^Fpa,   Aa^Fpa,   Aa^Fpa,   Aa^Fpa,   Aa^Fpa,   Aa^Fpa,    Gg^Ve,   Aa^Fpa,       Ai,       Ai,       Ai,       Ai,       Ha,       Ha,       Ha,       Ha,       Ha,       Ha,       Ha,       Ha
   Aa^Fpa,   Aa^Fpa,    Gg^Ve,   Aa^Fpa,   Aa^Fpa,   Aa^Fpa,   Aa^Fpa,   Aa^Fpa,   Aa^Fpa,   Aa^Fpa,   Aa^Fpa,   Aa^Fpa,   Aa^Fpa,   Aa^Fpa,   Aa^Fpa,   Aa^Fpa,       Ai,       Ai,       Ai,       Ai,       Ai,       Ai,       Ai,       Ai,       Ha,       Ha,       Ha,       Ha,       Ha
   Aa^Fpa,   Aa^Fpa,   Aa^Fpa,   Aa^Fpa,   Aa^Fpa,   Aa^Fpa,   Aa^Fpa,   Aa^Fpa,   Aa^Fpa,   Aa^Fpa,   Aa^Fpa,   Aa^Fpa,   Aa^Fpa,   Aa^Fpa,   Aa^Fpa,   Aa^Fpa,       Ai,       Ai,       Ai,       Ai,       Ha,       Ha,       Ha,       Ha,       Ha,       Ha,       Ha,       Ha,       Ha
   Aa^Fpa,   Aa^Fpa,   Aa^Fpa,   Aa^Fpa,   Aa^Fpa,   Aa^Fpa,   Aa^Fpa,   Aa^Fpa,   Aa^Fpa,   Aa^Fpa,   Aa^Fpa,   Aa^Fpa,   Aa^Fpa,   Aa^Fpa,   Aa^Fpa,    Gg^Ve,       Ai,       Ai,       Ai,       Ha,       Ha,       Ha,       Ha,       Ha,       Ha,       Ha,       Ha,       Ha,       Ha
   Aa^Fpa,   Aa^Fpa,   Aa^Fpa,   Aa^Fpa,   Aa^Fpa,   Aa^Fpa,   Aa^Fpa,   Aa^Fpa,   Aa^Fpa,   Aa^Fpa,    Gg^Ve,   Aa^Fpa,   Aa^Fpa,   Aa^Fpa,   Aa^Fpa,   Aa^Fpa,   Aa^Fpa,       Ai,       Ai,       Ai,       Ha,       Ha,       Ha,       Ha,       Ha,       Ha,       Ha,       Ha,       Ha
   Aa^Fpa,   Aa^Fpa,   Aa^Fpa,   Aa^Fpa,   Aa^Fpa,    Gg^Ve,   Aa^Fpa,   Aa^Fpa,   Aa^Fpa,   Aa^Fpa,   Aa^Fpa,   Aa^Fpa,   Aa^Fpa,    Gg^Ve,   Aa^Fpa,   Aa^Fpa,   Aa^Fpa,       Ai,       Ai,       Ai,       Ai,       Ai,       Ai,       Ai,       Ai,       Ai,       Ha,       Ha,       Ha
   Aa^Fpa,   Aa^Fpa,   Aa^Fpa,   Aa^Fpa,   Aa^Fpa,    Gg^Ve,   Aa^Fpa,   Aa^Fpa,   Aa^Fpa,   Aa^Fpa,   Aa^Fpa,   Aa^Fpa,   Aa^Fpa,    Gg^Ve,   Aa^Fpa,   Aa^Fpa,   Aa^Fpa,       Ai,       Ai,       Ai,       Ai,       Ai,       Ai,       Ai,       Ai,       Ai,       Ha,       Ha,       Ha
