
border_size=1
usage=map

       Mm,       Mm,       Ha,       Ch,       Ch,       Ch,       Ds,       Ai,       Ds,       Ai,       Ai,   Aa^Fpa,   Aa^Fpa,   Aa^Fpa,    Gg^Ve,    Gg^Vh,   Aa^Fpa,       Ai,       Ai,       Mm,    Gg^Ve,       Mm,       Mm,       Mm,       Mm,       Mm,       Mm,       Mm,       Mm,       Mm
       Mm,       Mm,       Ha,       Ch,       Ch,       Ch,       Ds,       Ai,       Ds,       Ai,       Ai,   Aa^Fpa,   Aa^Fpa,   Aa^Fpa,    Gg^Ve,    Gg^Vh,   Aa^Fpa,       Ai,       Ai,       Mm,    Gg^Ve,       Mm,       Mm,       Mm,       Mm,       Mm,       Mm,       Mm,       Mm,       Mm
       Mm,       Mm,       Mm,       Ch,     2 Kh,       Ch,       Ai,       Ai,       Ai,       Ai,       Ds,       Ai,       Ds,       Ai,       Ds,   Aa^Fpa,   Aa^Fpa,       Ai,       Ss,       Mm,       Mm,       Mm,       Mm,       Mm,       Mm,   Aa^Fpa,       Ha,       Ha,       Ha,       Ha
       Ha,       Ha,       Ha,       Ch,       Ch,       Ch,       Ai,       Ai,       Ds,       Ds,       Ai,       Ds,       Ds,       Ds,       Ds,       Ai,       Ai,       Ss,       Ai,       Ss,   Ss^Vhs,       Ai,       Ai,       Ai,    Gg^Ve,   Aa^Fpa,       Ha,       Ha,   Aa^Fpa,   Aa^Fpa
       Ha,       Ha,       Ha,       Ha,       Ha,       Ai,       Ai,       Ai,       Ai,       Ai,       Ai,       Ai,       Ai,       Ai,       Ai,       Ai,       Ai,       Ai,       Ai,       Ha,       Ha,       Ha,   Aa^Fpa,   Aa^Fpa,       Ha,       Ha,   Aa^Fpa,   Aa^Fpa,   Aa^Fpa,   Aa^Fpa
       Ha,       Ha,       Ha,       Ha,       Ha,       Ai,       Ai,       Ai,       Ai,       Ai,       Ai,       Ai,       Ai,       Ai,       Ai,       Ai,       Ai,       Ai,       Ai,       Ai,       Ai,       Ai,       Ai,       Ai,   Aa^Fpa,   Aa^Fpa,   Aa^Fpa,   Aa^Fpa,   Aa^Fpa,   Aa^Fpa
       Ha,       Ha,       Ha,       Ha,       Ha,       Ha,       Ai,       Ai,       Ai,       Ai,       Ai,       Ai,       Ai,       Ai,       Ai,       Ai,       Ai,       Ai,       Ai,       Ai,       Ai,       Ai,       Ai,   Aa^Fpa,   Aa^Fpa,   Aa^Fpa,   Aa^Fpa,   Aa^Fpa,   Aa^Fpa,   Aa^Fpa
       Ha,       Ha,       Ha,       Ha,       Ha,       Ha,       Ai,       Ai,       Ai,       Ai,       Ai,       Ai,       Ai,       Ai,       Ai,       Ai,       Ai,       Ai,       Ai,       Ai,       Ai,       Ai,       Ai,       Ai,   Aa^Fpa,   Aa^Fpa,   Aa^Fpa,   Aa^Fpa,   Aa^Fpa,   Aa^Fpa
       Ha,       Ha,       Ha,       Ha,       Ha,       Ha,       Ai,       Ai,       Ai,       Ai,       Ai,       Ai,       Ai,       Ai,       Ai,       Ai,       Ai,       Ai,       Ai,       Ai,       Ai,       Ai,       Ai,       Ai,   Aa^Fpa,   Aa^Fpa,   Aa^Fpa,   Aa^Fpa,   Aa^Fpa,   Aa^Fpa
       Ha,       Ha,       Ha,       Ai,       Ai,       Ai,       Ai,       Ai,       Ds,       Ai,    Gg^Vh,       Ai,       Ds,    Gg^Ve,       Ai,       Ai,    Gg^Vh,       Ai,       Ai,       Ai,       Ai,       Ai,       Ai,       Ai,       Ai,       Ai,   Aa^Fpa,   Aa^Fpa,   Aa^Fpa,   Aa^Fpa
       Ha,       Ha,       Ha,       Ha,       Ai,       Ai,       Ai,       Ai,       Ds,       Ds,       Ds,       Ds,       Ds,       Ds,       Ds,       Ds,       Ds,       Ds,   Aa^Fpa,   Aa^Fpa,   Aa^Fpa,       Ss,       Ai,       Ai,       Ai,   Aa^Fpa,   Aa^Fpa,   Aa^Fpa,   Aa^Fpa,   Aa^Fpa
       Ha,       Ha,       Ha,       Ha,       Ha,       Ha,       Ai,       Ai,       Ai,       Ds,       Ds,       Ds,       Ds,       Ai,       Ds,       Ds,    Gg^Ve,       Ds,   Aa^Fpa,   Aa^Fpa,       Ss,       Ss,       Ai,       Ss,       Ss,   Aa^Fpa,   Aa^Fpa,   Aa^Fpa,   Aa^Fpa,   Aa^Fpa
       Ha,       Ha,       Ha,       Ha,       Ha,       Ha,       Ha,       Ai,       Ai,       Ai,       Ai,       Ai,       Ai,       Ai,       Ai,       Ds,       Ai,       Ai,       Ai,       Ss,       Ss,       Ai,       Ai,   Aa^Fpa,   Aa^Fpa,   Aa^Fpa,   Aa^Fpa,   Aa^Fpa,   Aa^Fpa,   Aa^Fpa
       Mm,       Mm,       Ha,       Ha,       Ha,       Ha,       Ha,       Ha,       Ai,       Ai,       Ai,       Ai,       Ai,    Gg^Ve,   Aa^Fpa,       Ai,       Ai,       Ss,       Ss,       Ss,   Ss^Vhs,       Ss,       Ai,       Ai,       Ss,       Ai,       Ai,       Ai,       Ai,       Ai
       Mm,       Mm,       Ha,       Ha,       Ha,       Ha,       Ha,       Ha,       Ha,       Ai,   Aa^Fpa,   Aa^Fpa,   Aa^Fpa,   Aa^Fpa,   Aa^Fpa,       Ai,       Ai,       Ss,       Ss,       Ai,       Ss,       Ss,       Ss,       Ss,       Ss,       Ai,       Ai,       Ai,       Ai,       Ai
       Mm,       Mm,       Ha,       Ha,       Ha,       Ha,       Ha,   Aa^Fpa,   Aa^Fpa,   Aa^Fpa,    Gg^Ve,   Aa^Fpa,   Aa^Fpa,   Aa^Fpa,       Ai,       Ai,       Ai,       Ai,       Ww,       Ss,       Ww,       Ss,       Ss,       Ss,       Ai,       Ai,       Ai,       Ai,       Ai,       Ai
       Mm,       Mm,       Ha,       Ha,   Aa^Fpa,   Aa^Fpa,   Aa^Fpa,   Aa^Fpa,       Ai,       Ai,       Ai,   Aa^Fpa,   Aa^Fpa,   Aa^Fpa,   Aa^Fpa,       Ss,       Ss,       Ai,       Ai,       Ai,       Ai,       Ai,       Ai,       Ai,       Ai,       Ai,       Ai,       Ai,       Ai,       Ai
       Mm,       Mm,       Ha,       Ha,   Aa^Fpa,   Aa^Fpa,       Ai,       Ai,       Ai,       Ai,       Ai,       Ai,       Ai,       Ai,       Ai,       Ai,       Ai,       Ha,       Ha,    Gg^Vh,       Ss,       Ai,       Ss,       Ai,       Ww,       Ww,   Aa^Fpa,   Aa^Fpa,       Ce,       Ce
       Mm,       Mm,       Ha,       Ha,       Ha,       Ha,       Ha,       Ha,   Aa^Fpa,   Aa^Fpa,       Ai,       Ai,       Ai,       Ai,       Ss,       Ss,       Ai,       Ai,       Ai,       Ss,       Ai,       Ai,       Ai,       Ai,       Ai,       Ce,       Ce,     1 Ke,       Ce,       Ce
       Ha,       Ha,       Ha,       Ha,       Ha,       Ha,       Ha,       Ch,       Ai,       Ai,       Ai,       Ai,       Ai,       Ss,       Ss,       Ai,       Ai,       Ai,       Ai,       Ai,       Ai,   Aa^Fpa,   Aa^Fpa,   Aa^Fpa,   Aa^Fpa,   Aa^Fpa,   Aa^Fpa,       Ce,   Aa^Fpa,   Aa^Fpa
       Ha,       Ha,       Ha,       Ha,       Ha,       Ha,       Ch,     3 Kh,       Ch,       Ha,       Ai,       Ai,    Gg^Vh,       Ss,       Ai,       Ai,       Ss,   Ss^Vhs,       Ss,       Ss,       Ss,       Ai,       Ai,   Aa^Fpa,   Aa^Fpa,   Aa^Fpa,   Aa^Fpa,   Aa^Fpa,   Aa^Fpa,   Aa^Fpa
       Ha,       Ha,       Ha,       Ha,       Ha,       Ha,       Ch,       Ch,       Ch,       Ha,       Ha,       Ai,       Ds,       Ai,       Ds,       Ai,   Aa^Fpa,       Ai,       Ss,       Ss,       Ai,       Ss,       Ai,       Ss,       Ai,   Aa^Fpa,   Aa^Fpa,   Aa^Fpa,   Aa^Fpa,   Aa^Fpa
       Ha,       Ha,       Ha,       Ha,       Ha,       Ha,       Ai,       Ai,       Ai,       Ai,       Ds,       Ai,       Ds,       Ds,       Ds,       Ai,   Aa^Fpa,   Aa^Fpa,   Aa^Fpa,       Ai,       Ai,    Gg^Vh,       Ai,       Ai,       Ss,   Aa^Fpa,   Aa^Fpa,   Aa^Fpa,   Aa^Fpa,   Aa^Fpa
       Ha,       Ha,       Ha,       Ha,       Ai,       Ai,       Ai,       Ds,       Ai,       Ai,       Ai,       Ds,       Ds,       Ai,       Ds,       Ai,       Ai,   Aa^Fpa,       Ds,       Ds,       Ai,       Ai,       Ai,       Ss,   Ss^Vhs,       Ai,       Ai,   Aa^Fpa,   Aa^Fpa,   Aa^Fpa
       Ha,       Ha,       Ha,       Ha,       Ai,       Ai,       Ai,       Ai,       Ai,       Ai,       Ds,       Ds,    Gg^Ve,       Ai,       Ai,       Ai,       Ds,       Ds,       Ds,       Ds,       Ds,   Aa^Fpa,   Aa^Fpa,   Aa^Fpa,   Aa^Fpa,   Aa^Fpa,   Aa^Fpa,   Aa^Fpa,   Aa^Fpa,   Aa^Fpa
       Ha,       Ha,       Ha,       Ha,       Ai,       Ai,    Gg^Ve,       Ds,       Ch,       Ds,       Ai,       Ai,       Ds,       Ds,       Ds,       Ai,       Ai,    Gg^Ve,       Ds,       Ds,       Ds,       Ds,   Aa^Fpa,   Aa^Fpa,   Aa^Fpa,   Aa^Fpa,   Aa^Fpa,   Aa^Fpa,   Aa^Fpa,   Aa^Fpa
       Ha,       Ha,       Ha,       Ha,       Ha,       Ai,       Ai,       Ai,       Ai,   Ww^Bw\,       Ds,       Ds,    Gg^Vh,       Ds,       Ds,       Ds,       Ds,       Ai,       Ai,       Ai,       Ds,       Ai,       Ss,       Ww,       Ss,       Ai,       Ai,       Ai,       Ai,       Ai
       Ha,       Ha,       Ha,       Ha,       Ha,       Ha,       Ai,       Ai,       Ai,       Ai,       Ai,       Ai,       Ai,       Ds,       Ds,       Ds,       Ai,    Gg^Vh,       Ai,       Ai,       Ai,       Ai,       Ai,       Ai,       Ai,       Ai,       Ai,       Ai,       Ai,       Ai
       Ha,       Ha,       Ha,    Gg^Ve,       Ha,       Ha,       Ai,       Ai,       Ai,       Ai,       Ai,   Aa^Fpa,   Aa^Fpa,   Aa^Fpa,   Aa^Fpa,   Aa^Fpa,   Aa^Fpa,    Gg^Ve,   Aa^Fpa,   Aa^Fpa,   Aa^Fpa,   Aa^Fpa,    Gg^Ve,   Aa^Fpa,   Aa^Fpa,   Aa^Fpa,       Ai,       Ai,       Ai,       Ai
       Aa,       Aa,       Ww,       Ww,   Aa^Fpa,   Aa^Fpa,   Aa^Fpa,   Aa^Fpa,    Gg^Ve,   Aa^Fpa,   Aa^Fpa,       Ds,    Gg^Vh,       Ds,       Ai,       Ai,       Ai,   Aa^Fpa,       Ai,       Ai,       Ai,   Aa^Fpa,   Aa^Fpa,    Gg^Ve,   Aa^Fpa,       Ai,       Ai,       Ai,       Ai,       Ai
       Aa,       Aa,       Ww,   Aa^Fpa,   Aa^Fpa,   Aa^Fpa,   Aa^Fpa,   Aa^Fpa,   Aa^Fpa,   Aa^Fpa,   Aa^Fpa,   Aa^Fpa,   Aa^Fpa,   Aa^Fpa,   Aa^Fpa,   Aa^Fpa,   Aa^Fpa,   Aa^Fpa,   Aa^Fpa,   Aa^Fpa,   Aa^Fpa,   Aa^Fpa,   Aa^Fpa,   Aa^Fpa,   Aa^Fpa,   Aa^Fpa,       Ai,       Ai,       Ai,       Ai
       Aa,       Aa,       Ww,   Aa^Fpa,   Aa^Fpa,   Aa^Fpa,   Aa^Fpa,   Aa^Fpa,   Aa^Fpa,   Aa^Fpa,   Aa^Fpa,   Aa^Fpa,   Aa^Fpa,   Aa^Fpa,   Aa^Fpa,   Aa^Fpa,   Aa^Fpa,   Aa^Fpa,   Aa^Fpa,   Aa^Fpa,   Aa^Fpa,   Aa^Fpa,   Aa^Fpa,   Aa^Fpa,   Aa^Fpa,   Aa^Fpa,       Ai,       Ai,       Ai,       Ai
