
border_size=1
usage=map

       Mm,       Mm,       Mm,       Mm,       Mm,       Mm,       Mm,       Mm,       Mm,       Mm,       Mm,       Mm,       Mm,       Mm,       Mm,       Mm,       Mm,       Mm,       Mm,       Mm,       Mm,       Mm,       Mm,       Mm,       Mm,       Mm,       Mm,       Mm,       Mm,       Mm,       Mm,       Mm,       Mm,       Mm,       Mm,       Mm,       Mm,       Mm,       Mm,       Mm
       Mm,       Mm,       Mm,       Mm,       Mm,       Mm,       Mm,       Mm,       Mm,       Mm,       Mm,       Mm,       Mm,       Mm,       Mm,       Mm,       Mm,       Mm,       Mm,       Mm,       Mm,       Mm,       Mm,       Mm,       Mm,       Mm,       Mm,       Mm,       Mm,       Mm,       Mm,       Mm,       Mm,       Mm,       Mm,       Mm,       Mm,       Mm,       Mm,       Mm
       Mm,       Mm,       Mm,       Mm,       Gg,       Mm,       Mm,       Mm,       Mm,       Mm,       Mm,       Mm,       Re,       Re,       Re,       Mm,       Mm,       Mm,       Mm,       Mm,       Mm,       Mm,       Mm,       Mm,       Mm,       Mm,       Mm,       Mm,       Mm,    Gg^Ve,       Mm,       Mm,       Mm,       Mm,       Mm,       Mm,       Mm,    Gg^Ve,       Mm,       Mm
       Mm,       Mm,       Gg,       Gg,       Ch,       Gg,       Gg,       Mm,       Mm,       Mm,       Mm,       Mm,       Re,       Mm,       Mm,       Re,       Hh,    Gs^Fp,    Gs^Fp,    Gs^Fp,    Gs^Fp,       Mm,    Gs^Fp,       Mm,       Mm,       Mm,       Mm,       Mm,       Mm,       Mm,       Mm,       Mm,       Mm,       Mm,    Gg^Ve,       Mm,       Mm,       Mm,       Mm,       Mm
       Mm,       Mm,       Gg,       Ch,     1 Kh,       Ch,       Gg,       Re,       Re,       Mm,       Re,       Re,       Mm,       Mm,       Mm,       Hh,       Gg,    Gs^Fp,    Gs^Fp,    Gs^Fp,    Gs^Fp,    Gs^Fp,    Gs^Fp,       Mm,       Mm,       Mm,       Mm,       Mm,       Mm,       Mm,       Mm,       Mm,       Mm,       Mm,       Ce,       Ce,       Mm,       Mm,       Mm,       Mm
       Mm,       Mm,       Gg,       Ch,       Ch,       Ch,       Gg,       Mm,       Mm,       Re,       Mm,       Mm,       Mm,       Mm,       Hh,       Hh,       Gg,       Gg,    Gs^Fp,    Gs^Fp,    Gs^Fp,    Gs^Fp,    Gs^Fp,    Gs^Fp,    Gs^Fp,    Gs^Fp,    Gs^Fp,       Mm,    Gs^Fp,       Mm,       Mm,       Mm,       Hh,       Mm,       Mm,       Ce,     2 Ke,       Ce,       Mm,       Mm
       Mm,       Mm,       Mm,       Gg,    Gg^Ve,       Gg,       Mm,       Mm,       Mm,       Mm,       Mm,       Mm,       Mm,       Mm,       Hh,       Gg,       Gg,    Gs^Fp,    Gs^Fp,    Gs^Fp,    Gs^Fp,    Gs^Fp,    Gs^Fp,    Gs^Fp,    Gs^Fp,    Gs^Fp,       Gg,    Gs^Fp,       Gg,       Hh,       Hh,       Hh,       Hh,       Mm,       Mm,       Mm,       Mm,       Ce,       Mm,       Mm
       Mm,       Mm,       Mm,       Mm,       Mm,       Mm,       Mm,       Mm,       Mm,       Mm,       Mm,       Mm,       Mm,       Mm,       Hh,    Gg^Ve,       Gg,    Gs^Fp,    Gs^Fp,    Gs^Fp,    Gs^Fp,    Gs^Fp,    Gs^Fp,    Gs^Fp,    Gs^Fp,    Gg^Ve,       Gg,       Gg,       Gg,       Gg,       Gg,       Hh,       Hh,       Hh,       Mm,       Mm,       Mm,    Gg^Ve,       Mm,       Mm
       Mm,       Mm,       Mm,       Mm,       Mm,       Mm,       Mm,       Mm,       Mm,       Mm,       Hh,       Mm,       Hh,       Hh,       Hh,       Gg,    Gs^Fp,    Gs^Fp,    Gs^Fp,    Gs^Fp,       Ww,    Gs^Fp,       Ww,    Gs^Fp,    Gs^Fp,    Gs^Fp,    Gs^Fp,       Gg,       Gg,       Gg,       Gg,       Gg,       Hh,       Hh,       Hh,       Mm,       Mm,       Mm,       Mm,       Mm
       Mm,       Mm,       Mm,       Mm,       Mm,       Mm,       Mm,       Hh,       Hh,       Hh,       Hh,       Hh,       Hh,       Hh,       Gg,       Gg,       Ww,       Ww,       Ww,       Ww,       Ww,       Ww,       Ww,       Ww,       Ww,    Gs^Fp,    Gs^Fp,       Gg,       Gg,       Gg,       Gg,       Gg,       Gg,       Hh,       Hh,       Mm,       Mm,       Mm,       Mm,       Mm
       Mm,       Mm,       Mm,       Mm,       Mm,       Mm,       Hh,       Hh,       Hh,       Hh,       Gg,       Gg,       Gg,       Gg,       Ww,       Ww,       Ww,       Ww,       Ww,       Ww,       Ww,       Ww,       Ww,       Ww,       Ww,       Ww,       Ww,    Gs^Fp,       Gg,       Gg,       Gg,       Gg,       Gg,       Gg,       Hh,       Mm,       Mm,       Mm,       Mm,       Mm
       Mm,       Mm,       Mm,       Mm,       Mm,       Hh,       Hh,       Hh,       Gg,       Gg,    Gg^Ve,       Gg,       Gg,       Gg,       Ww,       Ww,       Ww,       Ww,       Ww,       Ww,       Ww,       Ww,       Ww,       Ww,       Ww,       Ww,       Ww,       Ww,       Gg,       Gg,       Gg,       Gg,       Gg,    Gg^Ve,       Hh,       Mm,       Mm,       Mm,       Mm,       Mm
       Mm,       Mm,       Mm,       Mm,       Mm,       Mm,       Hh,       Hh,       Gg,       Gg,       Gg,       Gg,       Gg,       Ww,       Ww,       Ww,       Ww,       Ww,       Ww,       Ww,       Wo,       Ww,       Ww,       Ww,       Ww,       Ww,       Ww,       Ww,       Gg,       Gg,       Gg,       Gg,       Hh,       Hh,       Mm,       Mm,       Mm,       Mm,       Mm,       Mm
       Mm,       Mm,       Mm,       Mm,       Mm,       Mm,       Hh,       Hh,       Gg,       Gg,       Gg,       Gg,       Gg,       Ww,       Ww,       Ww,       Ww,       Wo,       Wo,       Wo,       Wo,       Wo,       Ww,       Ww,       Ww,       Ww,       Ww,       Ww,       Gg,       Gg,       Gg,       Gg,       Hh,       Mm,       Mm,       Mm,       Mm,       Mm,       Mm,       Mm
       Mm,       Mm,       Mm,       Mm,       Mm,       Mm,       Mm,       Hh,       Gg,       Gg,       Gg,       Gg,       Ww,       Ww,       Ww,       Ww,       Wo,       Wo,       Wo,       Wo,       Wo,       Wo,       Wo,       Ww,       Ww,       Ww,       Ww,       Ww,       Ww,       Gg,       Gg,       Gg,       Hh,       Mm,       Mm,       Mm,       Mm,       Mm,       Mm,       Mm
       Mm,       Mm,       Mm,       Mm,       Mm,       Mm,       Mm,       Hh,       Gg,       Gg,       Gg,       Gg,       Ww,       Ww,       Ww,       Ww,       Wo,       Wo,       Wo,       Wo,       Wo,       Wo,       Wo,       Wo,       Wo,       Ww,       Ww,       Ww,       Ww,       Gg,       Gg,       Gg,       Hh,       Mm,       Mm,       Mm,       Mm,       Mm,       Mm,       Mm
       Mm,       Mm,       Mm,       Mm,       Mm,       Mm,       Hh,       Hh,       Gg,       Gg,       Gg,       Gg,       Ww,       Ww,       Ww,       Wo,       Wo,       Wo,       Wo,       Wo,       Wo,       Wo,       Wo,       Wo,       Wo,       Ww,       Ww,       Ww,       Ww,       Gg,       Gg,       Gg,       Gg,       Hh,       Mm,       Mm,       Mm,       Mm,       Mm,       Mm
       Mm,       Mm,       Mm,       Mm,       Hh,       Hh,       Hh,       Gg,       Gg,    Gg^Ve,       Gg,       Gg,       Ww,       Ww,       Ww,       Wo,       Wo,       Wo,       Wo,       Wo,       Wo,       Wo,       Wo,       Wo,       Wo,       Ww,       Ww,       Ww,       Ww,       Gg,       Gg,       Gg,       Gg,       Hh,       Hh,       Mm,       Mm,       Mm,       Mm,       Mm
       Mm,       Mm,       Mm,       Mm,       Hh,       Hh,       Hh,       Gg,       Gg,       Gg,       Gg,       Gg,       Ww,       Ww,       Ww,       Ww,       Ww,       Wo,       Wo,       Wo,       Wo,       Wo,       Wo,       Wo,       Wo,       Ww,       Ww,       Ww,       Gg,       Gg,       Gg,       Gg,    Gs^Fp,    Gs^Fp,       Mm,       Re,       Mm,       Mm,       Mm,       Mm
       Mm,       Mm,       Mm,       Mm,       Mm,       Hh,       Hh,       Hh,       Gg,       Gg,       Gg,       Gg,       Gg,       Ww,       Ww,       Ww,       Ww,       Ww,       Ww,       Wo,       Ww,       Wo,       Ww,       Ww,       Ww,       Ww,       Ww,       Ww,       Gg,       Gg,       Gg,    Gs^Fp,    Gs^Fp,    Gs^Fp,       Mm,       Re,       Mm,       Mm,       Mm,       Mm
       Mm,       Mm,       Mm,       Mm,       Mm,       Mm,       Hh,       Hh,       Gg,       Gg,       Gg,       Gg,       Gg,       Gg,       Ww,       Ww,       Ww,       Ww,       Ww,       Ww,       Ww,       Ww,       Ww,       Ww,       Ww,       Ww,       Ww,       Gg,       Gg,       Gg,    Gg^Ve,    Gs^Fp,    Gs^Fp,       Mm,       Mm,       Re,       Re,       Mm,       Mm,       Mm
       Mm,       Mm,       Mm,       Mm,       Mm,       Mm,       Hh,       Gg,       Gg,       Gg,       Gg,       Gg,       Gg,       Gg,       Gg,       Ww,       Ww,       Ww,       Ww,       Ww,       Ww,       Ww,       Ww,       Ww,       Ww,       Ww,       Gg,       Gg,       Gg,       Gg,    Gs^Fp,    Gs^Fp,    Gs^Fp,       Mm,       Mm,       Mm,       Mm,       Re,       Mm,       Mm
       Mm,       Mm,       Mm,       Mm,       Mm,       Mm,       Mm,       Hh,       Hh,       Gg,       Gg,       Gg,       Gg,       Gg,       Gg,       Ww,       Ww,       Ww,       Ww,       Ww,       Ww,       Ww,       Ww,       Ww,       Gg,       Gg,       Gg,       Gg,    Gs^Fp,    Gs^Fp,    Gs^Fp,    Gs^Fp,       Mm,       Mm,       Mm,       Mm,       Mm,       Re,       Mm,       Mm
       Mm,       Mm,       Mm,    Gg^Ve,       Mm,       Mm,       Mm,       Mm,       Mm,       Hh,       Hh,       Gg,       Gg,       Gg,       Gg,       Gg,       Gg,       Gg,       Gg,       Ww,       Gg,       Ww,    Gs^Fp,    Gs^Fp,    Gs^Fp,       Gg,    Gs^Fp,    Gs^Fp,    Gs^Fp,    Gs^Fp,       Mm,       Mm,       Mm,       Mm,       Mm,       Mm,       Re,       Re,       Mm,       Mm
       Mm,       Mm,       Mm,       Mm,       Mm,       Mm,       Mm,       Mm,       Mm,       Mm,       Mm,       Hh,       Hh,       Gg,       Gg,       Gg,       Gg,       Gg,       Gg,       Gg,    Gs^Fp,    Gs^Fp,    Gs^Fp,    Gs^Fp,    Gs^Fp,    Gs^Fp,    Gs^Fp,    Gs^Fp,       Mm,       Mm,       Mm,       Mm,       Mm,       Mm,       Gg,       Mm,       Re,       Mm,       Mm,       Mm
       Mm,       Mm,       Mm,       Mm,       Mm,       Mm,       Mm,       Mm,       Mm,       Mm,       Mm,       Mm,       Hh,       Hh,       Gg,       Gg,    Gg^Ve,       Gg,       Gg,       Gg,    Gs^Fp,    Gs^Fp,    Gs^Fp,    Gs^Fp,    Gs^Fp,    Gs^Fp,    Gs^Fp,    Gs^Fp,       Mm,       Mm,       Mm,       Mm,    Gg^Ve,       Gg,       Ch,       Gg,       Gg,       Mm,       Mm,       Mm
       Mm,       Mm,       Mm,       Mm,       Mm,       Mm,       Mm,    Gg^Ve,       Mm,       Mm,       Mm,       Mm,       Mm,       Hh,       Hh,       Gg,       Gg,       Gg,       Gg,       Gg,    Gs^Fp,    Gs^Fp,    Gs^Fp,    Gs^Fp,    Gs^Fp,    Gs^Fp,    Gs^Fp,    Gs^Fp,       Mm,       Mm,       Mm,       Mm,       Gg,       Ch,     3 Kh,       Ch,       Gg,       Mm,       Mm,       Mm
       Mm,       Mm,       Mm,    Gg^Ve,       Mm,       Mm,       Mm,       Mm,       Mm,       Mm,       Mm,       Mm,       Mm,       Hh,       Hh,       Hh,       Gg,       Gg,       Gg,       Gg,       Hh,    Gs^Fp,    Gs^Fp,    Gs^Fp,       Mm,    Gs^Fp,    Gs^Fp,    Gs^Fp,       Mm,       Mm,       Mm,       Mm,       Gg,       Ch,       Ch,       Ch,       Gg,       Mm,       Mm,       Mm
       Mm,       Mm,       Mm,       Mm,       Mm,       Mm,       Mm,       Mm,       Mm,       Mm,       Mm,       Mm,       Mm,       Mm,       Mm,       Hh,       Hh,       Hh,       Hh,       Hh,       Hh,    Gs^Fp,       Mm,       Mm,       Mm,       Mm,       Mm,       Mm,       Mm,       Mm,       Mm,       Mm,       Mm,       Gg,       Gg,       Gg,       Mm,       Mm,       Mm,       Mm
       Mm,       Mm,       Mm,       Mm,       Mm,       Mm,       Mm,       Mm,       Mm,    Gg^Ve,       Mm,       Mm,       Mm,       Mm,       Mm,       Mm,       Mm,       Mm,       Mm,       Hh,       Mm,       Mm,       Mm,       Mm,       Mm,       Mm,       Mm,       Mm,       Mm,       Mm,       Mm,       Mm,       Mm,       Mm,       Mm,       Mm,       Mm,       Mm,       Mm,       Mm
       Mm,       Mm,       Mm,       Mm,       Mm,       Mm,       Mm,       Mm,       Mm,       Mm,       Mm,       Mm,       Mm,       Mm,       Mm,       Mm,       Mm,       Mm,       Mm,       Mm,       Mm,       Mm,       Mm,       Mm,       Mm,       Mm,       Mm,       Mm,       Mm,       Mm,       Mm,       Mm,       Mm,       Mm,       Mm,       Mm,       Mm,       Mm,       Mm,       Mm
       Mm,       Mm,       Mm,       Mm,       Mm,       Mm,       Mm,       Mm,       Mm,       Mm,       Mm,       Mm,       Mm,       Mm,       Mm,       Mm,       Mm,       Mm,       Mm,       Mm,       Mm,       Mm,       Mm,       Mm,       Mm,       Mm,       Mm,       Mm,       Mm,       Mm,       Mm,       Mm,       Mm,       Mm,       Mm,       Mm,       Mm,       Mm,       Mm,       Mm
