
border_size=1
usage=map

    Gs^Fp,    Gs^Fp,    Gs^Fp,    Gs^Fp,    Gs^Fp,       Ce,       Ce,       Ce,    Gs^Fp,    Gs^Fp,    Gs^Fp,    Gs^Fp,    Gs^Fp,       Mm,       Mm,       Mm,       Mm,       Mm,       Mm,       Mm,       Mm,       Mm,       Mm,       Mm,       Hh,    Gs^Fp,    Gs^Fp,       Re,    Gs^Fp,    Gs^Fp,       Mm,       Mm
    Gs^Fp,    Gs^Fp,    Gs^Fp,    Gs^Fp,    Gs^Fp,       Ce,       Ce,       Ce,    Gs^Fp,    Gs^Fp,    Gs^Fp,    Gs^Fp,    Gs^Fp,       Mm,       Mm,       Mm,       Mm,       Mm,       Mm,       Mm,       Mm,       Mm,       Mm,       Mm,       Hh,    Gs^Fp,    Gs^Fp,       Re,    Gs^Fp,    Gs^Fp,       Mm,       Mm
    Gs^Fp,    Gs^Fp,    Gs^Fp,    Gs^Fp,    Gs^Fp,       Ce,     1 Ke,       Ce,    Gs^Fp,    Gs^Fp,    Gs^Fp,    Gs^Fp,       Mm,       Mm,       Mm,       Mm,       Mm,       Mm,       Mm,       Mm,       Mm,       Mm,       Mm,       Hh,       Hh,    Gs^Fp,       Re,       Re,    Gs^Fp,       Hh,       Mm,       Mm
    Gs^Fp,    Gs^Fp,    Gs^Fp,    Gs^Fp,    Gs^Fp,    Gs^Fp,       Ce,       Ce,       Ce,       Mm,       Mm,       Mm,       Mm,       Mm,       Mm,       Mm,       Mm,       Mm,    Gg^Ve,       Mm,       Mm,       Mm,       Mm,       Hh,       Hh,    Gs^Fp,       Re,    Gs^Fp,       Hh,       Hh,       Mm,       Mm
    Gs^Fp,    Gs^Fp,    Gs^Fp,    Gs^Fp,    Gs^Fp,    Gs^Fp,    Gs^Fp,    Gs^Fp,       Hh,       Mm,       Mm,    Gg^Ve,       Mm,       Mm,       Mm,       Gg,       Gg,       Gg,       Gg,       Gg,       Hh,       Hh,       Hh,       Gg,       Gg,       Gg,       Re,    Gs^Fp,       Hh,       Hh,       Mm,       Mm
    Gs^Fp,    Gs^Fp,    Gg^Ve,    Gs^Fp,    Gs^Fp,    Gs^Fp,    Gs^Fp,    Gs^Fp,       Hh,       Hh,       Mm,       Mm,       Mm,       Mm,       Mm,       Hh,    Gg^Ve,       Hh,       Hh,       Hh,       Hh,       Hh,       Hh,       Hh,       Gg,       Gg,       Re,       Gg,       Mm,       Mm,       Mm,       Mm
    Gs^Fp,    Gs^Fp,    Gs^Fp,    Gs^Fp,    Gs^Fp,       Mm,       Mm,    Gs^Fp,    Gs^Fp,    Gs^Fp,    Gs^Fp,    Gs^Fp,       Gg,       Gg,       Gg,       Gg,       Gg,       Gg,       Gg,       Gg,       Gg,       Gg,       Gg,       Gg,       Re,       Re,    Gg^Ve,       Hh,       Mm,       Mm,       Mm,       Mm
    Gs^Fp,    Gs^Fp,    Gs^Fp,    Gs^Fp,    Gg^Ve,       Mm,       Mm,       Ww,       Ww,       Ww,       Gg,       Gg,       Gg,       Gg,       Gg,       Gg,       Gg,       Gg,       Gg,       Gg,       Mm,       Mm,       Mm,       Mm,       Gg,       Gg,       Hh,       Hh,       Mm,       Mm,       Mm,       Mm
    Gs^Fp,    Gs^Fp,    Gs^Fp,    Gs^Fp,       Mm,       Mm,       Mm,       Mm,       Mm,       Mm,       Mm,    Gg^Ve,    Gs^Fp,    Gs^Fp,    Gs^Fp,       Gg,       Gg,       Hh,       Hh,       Hh,       Hh,       Hh,       Hh,       Hh,       Hh,       Ss,       Hh,       Hh,       Mm,       Mm,       Mm,       Mm
    Gs^Fp,    Gs^Fp,    Gs^Fp,    Gs^Fp,    Gs^Fp,    Gg^Ve,       Hh,       Mm,       Mm,       Mm,       Mm,    Gs^Fp,    Gs^Fp,    Gs^Fp,    Gs^Fp,       Gg,       Gg,       Hh,       Hh,       Hh,       Mm,       Mm,       Mm,       Mm,       Mm,       Mm,       Mm,       Mm,       Mm,       Mm,       Mm,       Mm
       Ww,       Ww,       Ww,       Mm,       Mm,       Mm,       Mm,       Mm,       Mm,       Mm,       Mm,       Mm,       Mm,       Gg,       Gg,       Gg,       Gg,       Hh,       Hh,       Hh,       Hh,       Hh,       Hh,       Mm,       Mm,       Ce,       Ce,       Ce,       Mm,       Ww,       Ww,       Ww
       Ww,       Ww,       Ww,       Ww,       Mm,       Mm,       Mm,       Mm,       Mm,       Mm,       Mm,       Mm,       Mm,       Mm,       Gg,       Ce,       Ce,       Ce,       Hh,       Hh,       Hh,       Mm,       Mm,    Gg^Ve,       Mm,       Ce,     6 Ke,       Ce,       Ww,       Ww,       Ww,       Ww
       Mm,       Mm,       Ww,       Ww,       Ww,       Ww,       Ww,       Hh,       Hh,       Hh,       Hh,       Hh,       Hh,       Gg,       Gg,       Ce,     3 Ke,       Ce,       Hh,       Hh,       Mm,       Mm,       Mm,       Mm,       Ww,       Ww,       Ww,       Ww,       Ww,    Gs^Fp,       Hh,       Hh
       Mm,       Mm,       Mm,       Mm,       Mm,       Mm,       Ww,       Ww,       Ww,       Ww,    Gs^Fp,       Hh,       Hh,       Gg,       Gg,       Ce,       Ce,       Ce,       Gg,       Hh,       Hh,       Mm,       Ww,       Ww,       Ww,       Ww,       Gg,       Gg,       Gg,       Hh,       Hh,       Hh
       Mm,       Mm,       Mm,       Mm,    Gs^Fp,    Gs^Fp,    Gs^Fp,    Gs^Fp,       Ww,       Ww,       Ww,       Ww,       Ww,       Gg,       Gg,       Gg,       Gg,       Gg,       Hh,       Hh,       Hh,       Ww,       Ww,       Ww,       Ww,       Gg,       Gg,       Gg,       Hh,       Hh,       Hh,       Hh
       Mm,       Mm,       Mm,       Mm,       Mm,    Gs^Fp,    Gs^Fp,       Hh,       Hh,       Hh,       Ww,       Ww,       Ww,       Ww,       Ww,       Gg,       Gg,       Gg,       Hh,       Hh,       Ww,       Ww,       Ww,       Ww,       Gg,       Gg,       Gg,       Gg,       Gg,       Hh,       Hh,       Hh
       Mm,       Mm,       Hh,       Hh,       Hh,       Hh,    Gs^Fp,    Gs^Fp,       Gg,       Gg,       Gg,       Ww,       Ww,       Ww,       Ww,       Ww,       Ww,       Ww,       Ww,       Ww,       Ww,       Ww,       Ww,       Gg,       Gg,       Gg,       Gg,       Gg,    Gg^Ve,       Hh,       Hh,       Hh
       Hh,       Hh,       Hh,       Gg,       Gg,       Gg,       Gg,       Gg,       Gg,       Gg,       Gg,       Ww,       Ww,       Ww,       Ww,       Ww,       Ww,       Ww,       Ww,       Ww,       Ww,       Ww,       Gg,       Gg,       Gg,       Gg,       Gg,       Gg,       Gg,       Gg,       Gg,       Gg
       Hh,       Hh,    Gs^Fp,    Gs^Fp,    Gs^Fp,       Gg,       Gg,       Gg,       Gg,       Gg,       Gg,       Gg,       Gg,       Gg,       Gg,       Gg,       Ww,       Ww,       Gg,       Gg,       Gg,       Gg,       Gg,       Gg,       Gg,       Gg,       Gg,    Gs^Fp,    Gs^Fp,    Gs^Fp,    Gs^Fp,    Gs^Fp
       Gg,       Gg,       Gg,       Gg,       Gg,       Gg,       Gg,       Gg,       Gg,       Gg,       Gg,       Gg,       Gg,       Gg,       Gg,       Gg,       Gg,       Gg,       Gg,       Gg,    Gg^Ve,       Gg,       Gg,       Gg,       Gg,       Gg,       Gg,       Gg,       Gg,       Gg,       Gg,       Gg
       Gg,       Gg,       Gg,       Gg,       Gg,       Gg,       Gg,       Gg,       Gg,    Gg^Ve,       Gg,       Gg,       Gg,       Gg,       Gg,       Gg,       Gg,       Gg,       Gg,       Gg,       Gg,       Gg,       Gg,       Gg,       Gg,       Gg,       Gg,       Gg,       Gg,       Gg,       Gg,       Gg
    Gs^Fp,    Gs^Fp,    Gs^Fp,    Gs^Fp,    Gs^Fp,    Gs^Fp,       Gg,       Gg,       Gg,       Gg,       Gg,       Gg,       Gg,       Ce,       Ce,       Ce,       Gg,       Gg,       Gg,       Gg,       Gg,       Gg,       Gg,       Gg,       Gg,       Gg,       Gg,       Gg,       Gg,       Gg,       Gg,       Gg
    Gs^Fp,    Gs^Fp,    Gs^Fp,    Gs^Fp,    Gs^Fp,    Gs^Fp,    Gs^Fp,       Gg,       Gg,       Gg,       Gg,       Gg,       Gg,       Ce,     2 Ke,       Ce,       Gg,       Gg,    Gg^Ve,       Gg,       Gg,       Gg,       Gg,       Gg,    Gg^Ve,       Gg,       Gg,       Gg,       Gg,       Gg,       Gg,       Gg
    Gs^Fp,    Gs^Fp,    Gs^Fp,    Gs^Fp,    Gs^Fp,    Gs^Fp,    Gs^Fp,       Gg,       Gg,       Gg,       Gg,       Gg,       Gg,       Ce,       Ce,       Ce,       Ce,       Gg,       Gg,       Gg,       Gg,       Gg,       Gg,       Gg,       Gg,       Gg,       Gg,       Gg,       Gg,       Gg,       Gg,       Gg
    Gs^Fp,    Gs^Fp,    Gs^Fp,    Gs^Fp,    Gs^Fp,    Gs^Fp,    Gs^Fp,    Gs^Fp,    Gs^Fp,       Gg,       Gg,       Gg,       Gg,       Gg,       Gg,       Gg,       Gg,       Gg,       Gg,       Gg,       Gg,       Gg,       Gg,    Gg^Ve,       Gg,       Gg,       Gg,       Gg,       Gg,       Gg,       Gg,       Gg
    Gs^Fp,    Gs^Fp,    Gs^Fp,    Gs^Fp,    Gs^Fp,    Gs^Fp,    Gs^Fp,    Gs^Fp,    Gs^Fp,    Gs^Fp,       Gg,       Gg,       Gg,       Gg,       Gg,       Gg,       Gg,    Gg^Ve,       Gg,       Gg,       Gg,       Gg,       Gg,       Gg,       Gg,       Gg,       Gg,       Gg,       Gg,       Gg,       Gg,       Gg
       Ce,       Ce,       Ce,    Gs^Fp,    Gs^Fp,    Gs^Fp,    Gs^Fp,    Gs^Fp,    Gs^Fp,    Gs^Fp,    Gs^Fp,    Gs^Fp,    Gs^Fp,    Gs^Fp,    Gs^Fp,    Gs^Fp,    Gs^Fp,       Gg,       Gg,       Gg,       Gg,       Gg,       Gg,       Gg,       Gg,       Gg,       Gg,       Gg,       Ce,       Ce,       Gg,       Gg
       Ce,       Ce,     4 Ke,       Ce,    Gs^Fp,    Gs^Fp,    Gs^Fp,    Gs^Fp,    Gs^Fp,    Gs^Fp,    Gs^Fp,    Gs^Fp,    Gs^Fp,    Gs^Fp,    Gs^Fp,    Gs^Fp,       Gg,       Gg,       Gg,       Gg,       Gg,       Gg,       Gg,       Gg,       Gg,       Gg,       Gg,       Gg,       Ce,     5 Ke,       Ce,       Ce
       Ce,       Ce,       Ce,       Ce,    Gs^Fp,    Gs^Fp,    Gs^Fp,    Gs^Fp,    Gs^Fp,    Gs^Fp,    Gs^Fp,    Gs^Fp,    Gs^Fp,    Gs^Fp,    Gs^Fp,    Gs^Fp,       Gg,       Gg,       Gg,       Gg,       Gg,       Gg,       Gg,       Gg,    Gg^Ve,       Gg,       Gg,       Gg,       Ce,       Ce,       Ce,       Ce
       Ce,       Ce,       Ce,       Ce,    Gs^Fp,    Gs^Fp,    Gs^Fp,    Gs^Fp,    Gs^Fp,    Gs^Fp,    Gs^Fp,    Gs^Fp,    Gs^Fp,    Gs^Fp,    Gs^Fp,    Gs^Fp,       Gg,       Gg,       Gg,       Gg,       Gg,       Gg,       Gg,       Gg,    Gg^Ve,       Gg,       Gg,       Gg,       Ce,       Ce,       Ce,       Ce
